COL titel VAL Eerste @honderdtal leerzame verhalen voor kinderen COL ondertitel VAL een leesboek voor de scholen COL hoofdauteur VAL Schmid, Johann Christoph Friedrich von Schmid 1768-1854 COL vertaling van VAL Lehrreiche kleine Erzählungen für Kinder	COL titel VAL Eerste @honderdtal leerzame verhalen voor kinderen COL ondertitel VAL een leesboek voor de scholen COL hoofdauteur VAL Schmid, Johann Christoph Friedrich von Schmid 1768-1854 COL editie VAL 15e dr COL vertaling van VAL Lehrreiche kleine Erzählungen für Kinder	0
COL titel VAL Tweede @honderdtal leerzame verhalen voor kinderen COL ondertitel VAL een leesboek voor de scholen COL hoofdauteur VAL Schmid, Johann Christoph Friedrich von Schmid 1768-1854 COL editie VAL [15e] dr COL vertaling van VAL Lehrreiche kleine Erzählungen für Kinder	COL titel VAL Tweede @honderdtal leerzame verhalen voor kinderen COL ondertitel VAL een leesboek voor de scholen COL hoofdauteur VAL Schmid, Johann Christoph Friedrich von Schmid 1768-1854 COL vertaling van VAL Lehrreiche kleine Erzählungen für Kinder	0
COL titel VAL De @avonturen van Suske en Wiske COL ondertitel VAL De rammelende rally COL ondertitel VAL speciale editie n.a.v. het 50-jarig bestaan van de Toeristische Federatie van de Provincie Antwerpen, 1948-1998 COL hoofdauteur VAL Vandersteen, Willy Jan Frans Maria Vandersteen 1913-1990	COL titel VAL De @avonturen van Suske en Wiske COL ondertitel VAL Het vliegende bed COL hoofdauteur VAL Vandersteen, Willy Jan Frans Maria Vandersteen 1913-1990	0
COL titel VAL @God beproeft en beschermt de onschuld COL ondertitel VAL een geschenk voor godvruchtige kinderen COL hoofdauteur VAL Schmid, Johann Christoph Friedrich von Schmid 1768-1854 COL editie VAL 3e dr	COL titel VAL @God beproeft en beschermt de onschuld COL ondertitel VAL een geschenk voor godvruchtige kinderen COL hoofdauteur VAL Schmid, Johann Christoph Friedrich von Schmid 1768-1854 COL editie VAL 2e dr	0
COL titel VAL De @drie musketiers COL hoofdauteur VAL Dumas, Alexandre Dumas 1802-1870 COL 2e auteur VAL Leloir, Maurice Leloir 1851-1940 COL vertaling van VAL Les trois mousquetaires. - 1844.	COL titel VAL De @drie musketiers COL hoofdauteur VAL Dumas, Alexandre Dumas 1802-1870 COL 2e auteur VAL Bruggen, Carolina Lea van Bruggen 1881-1932 COL vertaling van VAL Les trois mousquetaires. - 1844	0
COL titel VAL @Jan met de pijp COL ondertitel VAL vertellingen voor het jonge volkje COL hoofdauteur VAL Louwerse, Pieter Louwerse 1840-1908 COL 2e auteur VAL Sluijters, Johannes Carolus Bernardus Sluijters 1881-1957 COL editie VAL 3e, verb. dr COL Ook verschenen in VAL In het schemeruur. - 1911	COL titel VAL @Jan met de pijp COL ondertitel VAL vertellingen voor het jonge volkje COL hoofdauteur VAL Louwerse, Pieter Louwerse 1840-1908 COL editie VAL 2e, verb. dr COL Ook verschenen in VAL In het schemeruur. - 1911	0
COL titel VAL @Poppedijn COL hoofdauteur VAL Cramer, Marie Cramer 1887-1977	COL titel VAL @Poppedijn COL hoofdauteur VAL Cramer, Marie Cramer 1887-1977	0
COL titel VAL @Kapitein Pamphile COL hoofdauteur VAL Dumas, Alexandre Dumas 1802-1870 COL 2e auteur VAL Pollen, W.L. Pollen COL 2e auteur VAL Oxenaar, Robert Deodaat Emile Oxenaar 1929-2017 COL vertaling van VAL Le capitaine Pamphile	COL titel VAL @Kapitein Pamphile COL hoofdauteur VAL Dumas, Alexandre Dumas 1802-1870 COL 2e auteur VAL Pollen, W.L. Pollen COL 2e auteur VAL Oxenaar, Robert Deodaat Emile Oxenaar 1929-2017 COL vertaling van VAL Le capitaine Pamphile	0
COL titel VAL De @hond in de boekenkast COL ondertitel VAL verhalen van José Maria Arguedas, Thomas Mann, Joop Waasdorp, J.M.A. Biesheuvel, Adriaan van Dis, Rudy Kousbroek, Jules Renard, Ethel Portnoy, Henk Romijn Meijer, B. Traven, Huub Beurskens, Manuel Vázquez Montalbán, Gabriel García Márquez, Etienne van Heerden, Ben Borgart en Roald Dahl COL 2e auteur VAL Arguedas, José María Arguedas Altamirano 1911-1969 COL editie VAL 2e dr	COL titel VAL De @hond in de boekenkast COL ondertitel VAL verhalen van José María Arguedas, Thomas Mann, Joop Waasdorp, J.M.A. Biesheuvel, Adriaan van Dis, Rudy Kousbroek, Jules Renard, Ethel Portnoy, Henk Romijn Meijer, B. Traven, Huub Beurskens, Manuel Vázquez Montalbán, Gabriel García Márquez, Etienne van Heerden, Ben Bogart en Raold Dahl COL 2e auteur VAL Arguedas, José María Arguedas Altamirano 1911-1969	0
COL titel VAL @Tot hier en niet verder COL 2e auteur VAL Bakker, Han Bakker COL 2e auteur VAL Luttels, G.H.H. Luttels	COL titel VAL @Tot hier en niet verder COL 2e auteur VAL Bakker, Han Bakker COL 2e auteur VAL Luttels, G.H.H. Luttels	0
COL titel VAL Het @Vlaamse sprookjesboek COL 2e auteur VAL Meyer, Lodewijk Maurits De Meyer 1895-1970 COL 2e auteur VAL Wely, Bramine Eelcoline Marie van Wely 1924-2007 COL 2e auteur VAL Meyer, Lutgart De Meyer COL editie VAL 6 dr	COL titel VAL Het @Vlaamse sprookjesboek COL 2e auteur VAL Meyer, Lodewijk Maurits De Meyer 1895-1970 COL 2e auteur VAL Meyer, Lutgart De Meyer COL editie VAL 7e dr	0
COL titel VAL @Aan zee COL ondertitel VAL verhalen en gedichten t.g.v. het vijftienjarig bestaan van uitgeverij Conserve COL 2e auteur VAL Bakker, Kees de Bakker 1950- COL 2e auteur VAL Alders, Johanna Adriana Braber 1946-2010 COL editie VAL 1e dr	COL titel VAL @Aan zee	0
COL titel VAL Het @verboden bacchanaal COL ondertitel VAL speelfilmscenario naar de roman van Simon Vestdijk COL 2e auteur VAL Vestdijk, Simon Vestdijk 1898-1971	COL titel VAL Het @verboden bacchanaal COL ondertitel VAL roman COL hoofdauteur VAL Vestdijk, Simon Vestdijk 1898-1971 COL editie VAL 2e dr	0
COL titel VAL @Tomte en de vos COL hoofdauteur VAL Lindgren, Astrid Anna Emilia Lindgren 1907-2002 COL 2e auteur VAL Wiberg, Harald Wiberg COL 2e auteur VAL Verschuren, Ineke Verschuren COL editie VAL 3e dr COL vertaling van VAL Räven och Tomten. - Cop. 1960 COL auteur/primair VAL Lindgren	COL titel VAL @Tomte en de vos COL hoofdauteur VAL Lindgren, Astrid Anna Emilia Lindgren 1907-2002 COL 2e auteur VAL Wiberg, Harald Wiberg COL 2e auteur VAL Verschuren, Ineke Verschuren COL Oorspr. Zweedse titel VAL Räven och Tomten. - Cop. 1960	0
COL titel VAL @Oorspronglyke Nederlandsche logogryphen, of De verzameling van vaderlandsche spreekwoorden COL 2e auteur VAL Martinet, Joannes Florentius Martinet 1729-1795	COL titel VAL @Oorspronkelijke Nederlandsche logogryphen, of De verzameling van vaderlandsche spreekwoorden COL 2e auteur VAL Martinet, Joannes Florentius Martinet 1729-1795 COL editie VAL [Herdr.]	0
COL titel VAL @Oorspronkelijke Nederlandsche logogryphen, of De verzameling van vaderlandsche spreekwoorden COL 2e auteur VAL Martinet, Joannes Florentius Martinet 1729-1795 COL editie VAL [Herdr.]	COL titel VAL @Oorspronglyke Nederlandsche logogryphen, of De verzameling van vaderlandsche spreekwoorden COL 2e auteur VAL Martinet, Joannes Florentius Martinet 1729-1795	0
COL titel VAL @Nuttig geschenkje voor kinderen	COL titel VAL @Nuttig geschenkje voor kinderen COL editie VAL [1e dr.]	0
COL titel VAL Het @prinsesje en de rode tovenaar COL hoofdauteur VAL Roggeveen, Leonard Roggeveen 1898-1959 COL editie VAL 3e dr	COL titel VAL Het @prinsesje en de rode tovenaar COL hoofdauteur VAL Roggeveen, Leonard Roggeveen 1898-1959 COL editie VAL 2e dr	0
COL titel VAL @Genoveva COL ondertitel VAL een verhaal voor de jeugd COL hoofdauteur VAL Schmid, Johann Christoph Friedrich von Schmid 1768-1854 COL vertaling van VAL Genovefa. - 1810	COL titel VAL @Genoveva COL hoofdauteur VAL Schmid, Johann Christoph Friedrich von Schmid 1768-1854 COL vertaling van VAL Genovefa. - 1810	0
COL titel VAL @Dans van de zwaan COL hoofdauteur VAL Konsalik, Heinz G. Konsalik COL 2e auteur VAL Rijsbergen, Miep Rijsbergen COL editie VAL 2e dr COL vertaling van VAL Es blieb nur ein rotes Segel. - München : Autor und AVA, cop. 1980	COL titel VAL @Dans van de zwaan COL hoofdauteur VAL Konsalik, Heinz G. Konsalik COL 2e auteur VAL Rijsbergen, Miep Rijsbergen COL editie VAL 3e dr COL vertaling van VAL Es blieb nur ein rotes Segel. - München : Autor und AVA, cop. 1980	0
COL titel VAL Een @trein reed voorbij COL hoofdauteur VAL Saris, Helena Barbara Wilhelmina Saris 1915-1999	COL titel VAL Een @trein reed voorbij COL hoofdauteur VAL Saris, Helena Barbara Wilhelmina Saris 1915-1999	0
COL titel VAL @Martha brazieltje COL hoofdauteur VAL Saris, Helena Barbara Wilhelmina Saris 1915-1999 COL Vervolg op VAL Weg van Wolkensteyn	COL titel VAL @Martha brazieltje COL hoofdauteur VAL Saris, Helena Barbara Wilhelmina Saris 1915-1999 COL editie VAL 1e dr COL Vervolg op VAL Weg van Wolkensteyn	0
COL titel VAL De @wonderlijke avonturen van Duimelot COL ondertitel VAL naar een volkssprookje uit den tijd van Koning Arthur COL editie VAL 2 herziene en vermeerderde druk	COL titel VAL De @wonderlijke avonturen van Duimelot COL ondertitel VAL naar een volkssprookje uit den tijd van Koning Arthur COL ondertitel VAL voor het eerst uit het Engelsch vertaald COL editie VAL Tweede herziene en vermeerderde druk	0
COL titel VAL @Dieren uit de gehele wereld ontmoeten elkaar COL 2e auteur VAL Uyl, ... Den Uyl	COL titel VAL @Dieren uit de gehele wereld ontmoeten elkaar COL hoofdauteur VAL Uyl, ... Den Uyl	0
COL titel VAL @Over Conserve COL ondertitel VAL de eerste roman van Willem Frederik Hermans COL 2e auteur VAL Anbeek, Anthonie Gerrit Hendrik Anbeek van der Meijden 1944- COL 2e auteur VAL Bakker, Kees de Bakker 1950- COL editie VAL 2e dr	COL titel VAL @Over Conserve COL ondertitel VAL de eerste roman van Willem Frederik Hermans COL 2e auteur VAL Anbeek, Anthonie Gerrit Hendrik Anbeek van der Meijden 1944- COL 2e auteur VAL Bakker, Kees de Bakker 1950- COL editie VAL 1e dr	0
COL titel VAL De @spin die het te druk had COL hoofdauteur VAL Carle, Eric Carle 1929-2021 COL 2e auteur VAL Schaap, Martine Schaap COL editie VAL 1e dr., grote kartoned COL vertaling van VAL The busy spider. - London : Hamish Hamilton, 1984 COL auteur/primair VAL Carle	COL titel VAL De @spin die het te druk had COL hoofdauteur VAL Carle, Eric Carle 1929-2021 COL 2e auteur VAL Schaap, Martine Schaap COL vertaling van VAL The busy spider. - London : Hamish Hamilton, 1984	0
COL titel VAL @Alle geluk van de wereld COL ondertitel VAL gelukbrengers uit verschillende landen COL 2e auteur VAL Toorn, Lilian van Toorn COL 2e auteur VAL Vomberg, Ellen Vomberg COL 2e auteur VAL Baarda, Frits Baarda 1955-2023 COL editie VAL 2e dr	COL titel VAL @Alle geluk van de wereld COL ondertitel VAL gelukbrengers uit verschillende landen COL 2e auteur VAL Toorn, Lilian van Toorn COL 2e auteur VAL Vomberg, Ellen Vomberg COL 2e auteur VAL Baarda, Frits Baarda 1955-2023	0
COL titel VAL @Fik COL hoofdauteur VAL Hulst, Willem Gerrit van de Hulst 1879-1963 COL 2e auteur VAL Bottema, Tjeerd Bottema 1884-1978 COL editie VAL 8e dr., 65e-70e duiz	COL titel VAL @Fik COL hoofdauteur VAL Hulst, Willem Gerrit van de Hulst 1879-1963 COL 2e auteur VAL Hulst COL editie VAL 19e dr	0
COL titel VAL De @verloren schuldbekentenis COL hoofdauteur VAL Gerdes, Eduard Gerdes 1821-1898	COL titel VAL De @verloren schuldbekentenis COL ondertitel VAL een verhaal voor jongelieden COL hoofdauteur VAL Gerdes, Eduard Gerdes 1821-1898 COL editie VAL [2e dr.]	0
COL titel VAL @M'n liefje, m'n duifje COL hoofdauteur VAL Dahl, Roald Dahl 1916-1990 COL 2e auteur VAL Edinga, Hans Edinga COL editie VAL 36e dr COL vertaling van VAL Someone like you. - New York : Knopf, 1953	COL titel VAL @M'n liefje, m'n duifje COL ondertitel VAL verhalen COL hoofdauteur VAL Dahl, Roald Dahl 1916-1990 COL 2e auteur VAL Edinga, Hans Edinga COL editie VAL 34e dr COL vertaling van VAL Someone like you. - New York : Knopf, 1953	0
COL titel VAL @Wonderbaarlyke en zeldzame historie van Thyl Ulenspiegel, van zyn schalke, listige potzen en boeveryen die hy zoo in zyn dood als ook in zyn leven bedreeven heeft COL ondertitel VAL zeer teydkortig en geneuglyk om te leezen COL ondertitel VAL voor ouden en jongen lieden	COL titel VAL @Wonderbaarlyke en zeldzaame historie, van Thyl Ulenspiegel, van zyn schalke, listige potzen en boeveryen, die hy zoo in zyn leven als ook in zyn dood bedreeven heeft. COL ondertitel VAL Zeer tydkortig en geneuglyk om te leezen. COL ondertitel VAL Voor oude en jonge lieden	0
COL titel VAL @Pakkie-an COL 2e auteur VAL Bakker, Han Bakker COL 2e auteur VAL Luttels, G.H.H. Luttels	COL titel VAL @Pakkie-an COL 2e auteur VAL Bakker, Han Bakker COL 2e auteur VAL Luttels, G.H.H. Luttels	0
COL titel VAL @Heel mijn hebben en houden COL 2e auteur VAL Bakker, Han Bakker COL 2e auteur VAL Grootel	COL titel VAL @Heel mijn hebben en houden COL 2e auteur VAL Bakker, Han Bakker COL 2e auteur VAL Grootel	0
COL titel VAL @Booi-baas COL ondertitel VAL [een katecheseprojekt over kind en macht] COL 2e auteur VAL Donkers COL 2e auteur VAL Schoorlemmer COL 2e auteur VAL Ollivier	COL titel VAL @Booi-baas COL ondertitel VAL [een katecheseprojekt over kind en macht] COL 2e auteur VAL Donkers COL 2e auteur VAL Schoorlemmer COL 2e auteur VAL Ollivier	0
COL titel VAL @Zondebok COL 2e auteur VAL Bakker, Han Bakker COL 2e auteur VAL Grootel	COL titel VAL @Zondebok COL 2e auteur VAL Bakker, Han Bakker COL 2e auteur VAL Grootel	0
COL titel VAL @Vertel je verhaal COL 2e auteur VAL Bakker, Han Bakker COL 2e auteur VAL Luttels	COL titel VAL @Vertel je verhaal COL 2e auteur VAL Bakker, Han Bakker COL 2e auteur VAL Luttels	0
COL titel VAL Het @huisje in de sneeuw COL hoofdauteur VAL Hulst, Willem Gerrit van de Hulst 1879-1963 COL editie VAL 8e dr	COL titel VAL Het @huisje in de sneeuw COL hoofdauteur VAL Hulst, Willem Gerrit van de Hulst 1879-1963 COL 2e auteur VAL Bottema COL editie VAL 13e dr	0
COL titel VAL @Vertellingen van Moeder de Gans COL 2e auteur VAL Schenkman, Jan Schenkman 1806-1863 COL 2e auteur VAL Doré, Louis Auguste Gustave Doré 1832-1883 COL editie VAL 5de druk	COL titel VAL @Vertellingen van Moeder de Gans COL 2e auteur VAL Doré, Louis Auguste Gustave Doré 1832-1883	0
COL titel VAL Het @leelijke jonge eendje en andere verhalen COL hoofdauteur VAL Andersen', Hans Christian Andersen 1805-1875 COL editie VAL 3e herz. en verm. dr	COL titel VAL Het @leelijke jonge eendje en andere verhalen COL hoofdauteur VAL Andersen, Hans Christian Andersen 1805-1875 COL editie VAL 2e herz. en verm dr	0
COL titel VAL @Sprookjes van Andersen COL hoofdauteur VAL Andersen, Hans Christian Andersen 1805-1875 COL 2e auteur VAL Andriessen, Simon Jacobus Andriessen 1831-1901 COL 2e auteur VAL Speckter, Otto Speckter 1807-1871 COL 2e auteur VAL Hutschenreuter, Louis Hutschenreuter illustrator	COL titel VAL @Sprookjes van Andersen COL hoofdauteur VAL Andersen, Hans Christian Andersen 1805-1875 COL 2e auteur VAL Andriessen, Simon Jacobus Andriessen 1831-1901 COL 2e auteur VAL Speckter, Otto Speckter 1807-1871 COL 2e auteur VAL Hutschenreuter, Louis Hutschenreuter illustrator	0
COL titel VAL @Papa, pak je de maan voor mij? COL hoofdauteur VAL Carle, Eric Carle 1929-2021 COL 2e auteur VAL Schaap, Martine Schaap COL editie VAL 3e dr COL vertaling van VAL Papa, please get the moon for me. - Picture Book, 1986	COL titel VAL @Papa, pak je de maan voor mij? COL hoofdauteur VAL Carle, Eric Carle 1929-2021 COL 2e auteur VAL Schaap, Martine Schaap COL vertaling van VAL Papa, please get the moon for me. - Picture Book, 1986	0
COL titel VAL @Leidraad voor het verkeersonderwijs COL ondertitel VAL voor de lagere scholen ten dienste van onderwijzeressen en onderwijzers COL 2e auteur VAL Wijngaarden van Rees COL editie VAL 6de druk	COL titel VAL @Leidraad voor het verkeersonderwijs COL ondertitel VAL voor de lagere scholen ten dienste van onderwijzeressen en onderwijzers COL 2e auteur VAL Wijngaarden van Rees, C.J. van Wijngaarden van Rees	0
COL titel VAL @Rumeiland COL ondertitel VAL uit de papieren van Richard Beckford behelzende het relaas van zijn lotgevallen op Jamaica, 1737-1738 COL hoofdauteur VAL Vestdijk, Simon Vestdijk 1898-1971 COL editie VAL 15e dr	COL titel VAL @Rumeiland COL ondertitel VAL uit de papieren van Richard Beckford, behelzende het relaas van zijn lotgevallen op Jamaica, 1737-1738 COL hoofdauteur VAL Vestdijk, Simon Vestdijk 1898-1971	0
COL titel VAL @Verborgen leven COL hoofdauteur VAL Rendell, Ruth Rendell 1930-2015 COL 2e auteur VAL Brink-Wessels, N.M. Brink-Wessels COL vertaling van VAL A sleeping life. - London : Hutchinson, 1978	COL titel VAL @Verborgen leven COL hoofdauteur VAL Rendell, Ruth Rendell 1930-2015 COL 2e auteur VAL Brink-Wessels, N.M. Brink-Wessels COL editie VAL 2e dr COL vertaling van VAL A sleeping life. - London : Hutchinson, cop. 1978	0
COL titel VAL De @ontbrekende schakel COL hoofdauteur VAL Thijssing-Boer, Henny Thijssing-Boer 1933-2011	COL titel VAL De @ontbrekende schakel COL hoofdauteur VAL Thijssing-Boer, Henny Thijssing-Boer 1933-2011	0
COL titel VAL De @gouden gans COL hoofdauteur VAL Grimm, Jacob Ludwig Carl Grimm 1785-1863 COL 2e auteur VAL Hildebrand, Annettes Dideric Hildebrand 1907-1977 COL 2e auteur VAL Lutz, Johannes Hermanus Lutz 1888-1957 COL editie VAL [Herdr.]	COL titel VAL De @gouden gans COL ondertitel VAL een sprookje van Grimm COL hoofdauteur VAL Grimm, Jacob Ludwig Carl Grimm 1785-1863 COL 2e auteur VAL Meijer, Marja Meijer 1966- COL Oorspr. verschenen in VAL Plons! / Martin Waddell en Jill Barton	0
COL titel VAL @Grenzeloos COL ondertitel VAL programmaboek	COL titel VAL @Grenzeloos COL ondertitel VAL verhalen over vele culturen COL 2e auteur VAL Asinga, Sherida Asinga 1980-	0
COL titel VAL Het @Omaha conflict COL hoofdauteur VAL Ludlum, Robert Ludlum 1927-2001 COL 2e auteur VAL Bruning, Frans J. Bruning COL editie VAL 6e dr COL vertaling van VAL The road to Omaha. - New York : Random House, 1992 COL Vervolg op VAL Het Shepherd commando	COL titel VAL Het @Omaha conflict COL ondertitel VAL roman van een ongelooflijke machtsstrijd COL hoofdauteur VAL Ludlum, Robert Ludlum 1927-2001 COL 2e auteur VAL Bruning, Frans J. Bruning COL vertaling van VAL The road to Omaha. - New York : Random House, 1992	0
COL titel VAL @Dolores Claiborne COL hoofdauteur VAL King, Stephen Edwin King 1947- COL 2e auteur VAL Duzee, Lucien Antoine Duzee 1943-2016 COL editie VAL 8e dr COL vertaling van VAL Dolores Claiborne. - New York : Viking, 1992	COL titel VAL @Dolores Claiborne COL hoofdauteur VAL King, Stephen Edwin King 1947- COL 2e auteur VAL Duzee, Lucien Antoine Duzee 1943-2016 COL vertaling van VAL Dolores Claiborne. - New York : Viking, 1992 COL auteur/primair VAL King	0
COL titel VAL @Ééns komt de dag COL ondertitel VAL roman voor oudere meisjes COL hoofdauteur VAL Saris, Helena Barbara Wilhelmina Saris 1915-1999 COL 2e auteur VAL Borrebach, Henri Carl Johan Elisa Borrebach 1903-1991	COL titel VAL @Eens komt de dag COL hoofdauteur VAL Saris, Helena Barbara Wilhelmina Saris 1915-1999 COL editie VAL [Herdr.]	0
COL titel VAL @Gebeden voor en na de H. Communie ten gebruike der kinderen	COL titel VAL @Frisch en fraai COL ondertitel VAL bloemlezing voor verder onderwijs aan Roomsch-Katholieke scholen COL 2e auteur VAL Wiltschut, Willem Wiltschut fl. 1917-ca. 1950 COL Vanaf 1921 serie voor 1e en 2e leerjaar o.d.t. VAL Frisch en fraai voor de kleintjes (10 dl.) COL Serie voor 2e-7e leerjaar o.d.t. VAL Frisch en fraai : bloemlezing uit de jeugdlectuur voor Roomsch-Katholieke scholen (18 dl.)	1
COL titel VAL @Boze opzet COL hoofdauteur VAL Steel, Danielle Fernande Steel 1947- COL 2e auteur VAL Benink, Carla Benink COL editie VAL 3e dr COL vertaling van VAL Malice. - London [etc.] : Bantam Press, 1996	COL titel VAL De @rattenvanger van Hameln COL ondertitel VAL pop-up	1
COL titel VAL @Open huis COL hoofdauteur VAL Mansell, Jill Mansell 1957- COL 2e auteur VAL Holwerda, Ytje Holwerda COL editie VAL 2e dr COL vertaling van VAL Open house. - London : Bantam Books, 1995	COL titel VAL @Noah's Ark ABC COL 2e auteur VAL Goodman, Willard Goodman	1
COL titel VAL Een @keeper is altijd alleen COL ondertitel VAL verhalen over de elfde man COL 2e auteur VAL Brouwer, Erik Brouwer 1972-	COL titel VAL Het @tooverpaard COL 2e auteur VAL Broecke, Jaak Floris van den Broecke Sr. 1913-1986	1
COL titel VAL @Oeroeg COL hoofdauteur VAL Haasse, Hélène Serafia Haasse 1918-2011 COL editie VAL 44e dr	COL titel VAL @Van goede familie COL hoofdauteur VAL Konsalik, Heinz G. Konsalik COL vertaling van VAL Eine angesehene Familie. - München : Bertelsmann, 1980	1
COL titel VAL @Tristan en Isolde COL hoofdauteur VAL Haar, Jacob Everard ter Haar 1922-1998 COL auteur/primair VAL Haar	COL titel VAL @Maigret en het lijk in de kast COL hoofdauteur VAL Simenon, Georges Joseph Christian Simenon 1903-1989 COL 2e auteur VAL Kool, Halbo Christiaan Kool 1907-1968 COL vertaling van VAL Les caves du majestic. - 1940	1
COL titel VAL Een @bruidsboeket als symbool COL hoofdauteur VAL Thijssing-Boer, Henny Thijssing-Boer 1933-2011	COL titel VAL De @kanten zakdoek COL ondertitel VAL een verhaal uit den ouden tijd COL hoofdauteur VAL Gerdes, Eduard Gerdes 1821-1898	1
COL titel VAL De @roode en witte rozen en: De nachtegaal COL ondertitel VAL twee verhalen voor de jeugd COL hoofdauteur VAL Schmid, Johann Christoph Friedrich von Schmid 1768-1854	COL titel VAL @Snow White and the seven dwarfs COL 2e auteur VAL Conover, Chris Conover 1950-	1
COL titel VAL Een @stoffelijk bewijs COL hoofdauteur VAL Thijssing-Boer, Henny Thijssing-Boer 1933-2011	COL titel VAL @Bij het maanlicht COL ondertitel VAL zangen en schetsen COL 2e auteur VAL H.R., H. R. fl. 1888 COL 2e auteur VAL Heije, Jan Pieter Heije 1809-1876	1
COL titel VAL @Silver bullet COL hoofdauteur VAL King, Stephen Edwin King 1947- COL 2e auteur VAL Bakker, Margot Bakker COL 2e auteur VAL Wrightson, Berni Wrightson 1948- COL editie VAL 4e dr COL vertaling van VAL Cycle of the werewolf. - New York : New American Library, 1983	COL titel VAL De @vleugelman COL ondertitel VAL een sprookje van Godfried Bomans COL hoofdauteur VAL Bomans, Godfried Jan Arnold Bomans 1913-1971	1
COL titel VAL Het @Osterman weekend COL hoofdauteur VAL Ludlum, Robert Ludlum 1927-2001 COL 2e auteur VAL Verhoef, Marleen Verhoef COL editie VAL 21e [i.e. 23e] dr COL vertaling van VAL The Osterman weekend. - New York : World Publ., 1972	COL titel VAL De @sociale positie van Sinterklaas COL hoofdauteur VAL Reve, Gerard Kornelis van het Reve 1923-2006	1
COL titel VAL @Stille eer COL hoofdauteur VAL Steel, Danielle Fernande Steel 1947- COL 2e auteur VAL Falger, Lon Falger COL editie VAL 2e dr COL vertaling van VAL Silent honour. - New York : Delacorte, 1996	COL titel VAL @Mooie jonge goden COL ondertitel VAL Vlaams literair talent COL 2e auteur VAL Albers, Frank Albers 1960-	1
COL titel VAL @Door liefde gedreven COL hoofdauteur VAL Steel, Danielle Fernande Steel 1947- COL 2e auteur VAL Schurink, Elly Schurink COL editie VAL 3e dr COL vertaling van VAL Crossings. - London : Hodder & Stoughton, 1982 COL auteur/primair VAL Steel	COL titel VAL @Avonturen van Thea Top in het Circus Pitoreski COL ondertitel VAL een amusant en spannend verhaal voor de jeugd	1
COL titel VAL Het @grote activiteiten- en spelletjesboek COL ondertitel VAL koken, verven, handenarbeid, wetenschap, tuinieren, goochelen, muziek maken en feestjes bouwen COL ondertitel VAL eenvoudige activiteiten voor jonge kinderen COL 2e auteur VAL Scheperkeuter, Gea Scheperkeuter COL 2e auteur VAL Deul, Eveline Deul COL 2e auteur VAL Freeman, John Freeman 1948- COL vertaling van VAL The ultimate show-me-how activity book. - London : Anness, cop. 1997	COL titel VAL @Van de raaf die Koetcha heette COL 2e auteur VAL Ratsjov, Jewgeni Michailowitsj Ratsjov 1906-1997 COL 2e auteur VAL Mijne, G. Mijne	1
COL titel VAL De @vierde man COL hoofdauteur VAL Reve, Gerard Kornelis van het Reve 1923-2006 COL editie VAL 7e dr	COL titel VAL Het @knapste varken van de hele wereld COL hoofdauteur VAL Busser, Marianne Busser 1958-2025 COL 2e auteur VAL Verstegen, Jeska Verstegen 1972-	1
COL titel VAL De @enige weg COL hoofdauteur VAL Marxveldt, Cissy van Marxveldt 1889-1948 COL editie VAL 2e dr COL Vervolg van VAL Puck van Holten	COL titel VAL @Dat weet ik zelf niet COL ondertitel VAL jonge mensen in boek en verhaal COL hoofdauteur VAL Haasse, Hélène Serafia Haasse 1918-2011	1
COL titel VAL De @kellner en de levenden COL hoofdauteur VAL Vestdijk, Simon Vestdijk 1898-1971 COL editie VAL 24e dr	COL titel VAL @Kijk en zoek met Thomas COL 2e auteur VAL Awdry, Wilbert Vere Awdry 1911-1997	1
COL titel VAL @Voor 't jonge volkje	COL titel VAL Les @deux frères COL hoofdauteur VAL Schmid, Johann Christoph Friedrich von Schmid 1768-1854 COL 2e auteur VAL Macker, abbé Macker	1
COL titel VAL @Legenden en sprookjes	COL titel VAL @Wat Joco en Coco aan wonderlijks beleefden COL 2e auteur VAL Wins, Johan Willem Marius Wins 1881-1940	1
COL titel VAL De @vreugde van het leven COL hoofdauteur VAL Cookson, Catherine Anne Cookson 1906-1998 COL 2e auteur VAL Mons, Annet Mons COL editie VAL 4e dr COL vertaling van VAL My beloved son. - London [etc.] : Bantam Press, 1991	COL titel VAL @Maigret en de miljoenenerfenis COL hoofdauteur VAL Simenon, Georges Joseph Christian Simenon 1903-1989 COL 2e auteur VAL Romijn, Karel Hendrik Romijn COL vertaling van VAL Maigret et les témoins récalcitrants. - Paris : Presses de la Cité, 1959	1
COL titel VAL @Zingende jeugd COL 2e auteur VAL Lovendaal, Gijsbertus Wilhelmus Lovendaal 1847-1939 COL 2e auteur VAL Weeren, Gerard Cornelis Weeren 1859-1915	COL titel VAL @Nuttig en aangenaam prentenboek	1
COL titel VAL @Dribbels eerste paasfeest COL hoofdauteur VAL Hill, Eric Hill 1927-2014 COL editie VAL 5e dr COL vertaling van VAL Spot's first Easter. - London : Ventura, 1988. - Oorspr. uitg.: London : Heinemann, 1987	COL titel VAL De @vuuraanbidders COL ondertitel VAL roman uit de tachtigjarige oorlog COL hoofdauteur VAL Vestdijk, Simon Vestdijk 1898-1971 COL editie VAL 6e dr	1
COL titel VAL @Vlucht naar de heuvels COL hoofdauteur VAL Cookson, Catherine Anne Cookson 1906-1998 COL 2e auteur VAL Nijkerk-Pieters, F.I. Nijkerk-Pieters COL editie VAL 11e dr COL vertaling van VAL The dwelling place. - London : Macdonald, 1971	COL titel VAL @Nieuwe Bolke de Beer omnibus COL hoofdauteur VAL Hildebrand, Annettes Dideric Hildebrand 1907-1977 COL 2e auteur VAL Bär von Hemmersweil, Raymond N. Bär van Hemmersweil 1929-	1
COL titel VAL De @gondelier van Venetië COL hoofdauteur VAL Zeeuw, Pieter de Zeeuw J.Gzn. 1890-1968 COL 2e auteur VAL _, Menno, Menno COL editie VAL 2e dr	COL titel VAL @Waar was ik toen ik er nog niet was? COL 2e auteur VAL Nilsson, Lennart Nilsson 1922- COL 2e auteur VAL Treffers, Pieter Eric Treffers 1928-2013 COL 2e auteur VAL Kernkamp-Biegel, Helena Phyllis Maria Kernkamp-Biegel 1922-2001 COL editie VAL 2e dr COL vertaling van VAL Så blev du till / tekst en red. Jan Cornell, Rune Pettersson ; medisch adviseur A. Ingelman-Sundberg	1
COL titel VAL @Zoeter dan honing COL ondertitel VAL veertien korte verhalen van vrouwen over wraak COL 2e auteur VAL Tuyll van Serooskerken, Caroline van Tuyll van Serooskerken COL editie VAL 3e dr	COL titel VAL Het @onwillige hart COL hoofdauteur VAL Peters, Karin Peters	1
COL titel VAL @Spionnen beminnen gevaarlijk COL hoofdauteur VAL Konsalik, Heinz G. Konsalik COL 2e auteur VAL Grashoff, Pieter Grashoff 1927-2010 COL editie VAL 11e dr COL vertaling van VAL Agenten lieben gefährlich. - München : Juncker, 1970	COL titel VAL @Vaderlandsch A.B. boek, of, Trekken en merkwaardigheden uit de vaderlandsche geschiedenis COL ondertitel VAL in alphabetische volgorde gerangschikt COL ondertitel VAL met 24 prent-afbeeldingen COL editie VAL Facs. herdr	1
COL titel VAL @Nederlandsch leesboek voor de lagere school COL editie VAL 3e dr	COL titel VAL @Lieve Sinterklaas COL hoofdauteur VAL Amant, Kathleen Amant 1969- COL editie VAL Eerste druk herwerkte versie	1
COL titel VAL @Grimm's Fairy Tales COL hoofdauteur VAL Grimm, Jacob Ludwig Carl Grimm 1785-1863 COL 2e auteur VAL Wehnert, E.H. Wehnert	COL titel VAL @Op eigen benen COL hoofdauteur VAL Marxveldt, Cissy van Marxveldt 1889-1948 COL 2e auteur VAL Borrebach, Henri Carl Johan Elisa Borrebach 1903-1991 COL 2e auteur VAL Herson, Herson COL editie VAL [Herdr.] COL Eerder verschenen onder de titels VAL Game and set ; Vriendinnen	1
COL titel VAL @Übungs-Buch für Elementar Schulen COL ondertitel VAL zum Lesenlernen geschriebener teutscher und lateinischer Schrift, in sehr verschiedenen Handschriften abgedruckt. Nebst einem kurzen Unterrichte im Briefschreiben zugleich als Muster zum Schönschreiben COL 2e auteur VAL Kämper, J.P.H. Kämper COL editie VAL 8e verbesserte Auflage	COL titel VAL De @vier zusjes March COL hoofdauteur VAL Alcott, Louisa May Alcott 1832-1888 COL 2e auteur VAL Peels, Johan Peels 1922-	1
COL titel VAL Een @hart moet beslissen COL hoofdauteur VAL Burgers-Drost, Julia Eveline Jolanda Burgers-Drost 1938-2013	COL titel VAL De @stadsmuzikanten van Bremen COL hoofdauteur VAL Grimm, Jacob Ludwig Carl Grimm 1785-1863 COL 2e auteur VAL Otto, Svend Otto Sørensen 1916-1996 COL 2e auteur VAL Niskos, L.M. Niskos COL vertaling van VAL Die Bremer Stadtmusikanten	1
COL titel VAL @Ingrids gezin COL hoofdauteur VAL Graaf, Anke de Graaf 1927-2019 COL auteur/primair VAL Graaf	COL titel VAL @Modelmenschen, geschetst door een Modelmensch	1
COL titel VAL @Vel over been COL hoofdauteur VAL King, Stephen Edwin King 1947- COL 2e auteur VAL Kuipers, Hugo Kuipers 1954-2013 COL vertaling van VAL Bag of bones. - New York : Scribner, 1998 COL auteur/primair VAL King	COL titel VAL @Hoe laat is het?	1
COL titel VAL @Peter Pan COL 2e auteur VAL Barrie, James Matthew Barrie 1860-1937	COL titel VAL @Afscheid van Kazachstan COL hoofdauteur VAL Konsalik, Heinz G. Konsalik COL 2e auteur VAL Amerongen, Jan van Amerongen 1939-1998 COL vertaling van VAL Westwind aus Kasachstan. - Rastatt : Hestia Verlag GmbH & Co. KG, ©1992	1
COL titel VAL @Vanilla P. COL hoofdauteur VAL Bel, Marc De Bel 1954- COL 2e auteur VAL Bosschaert, Jan Bosschaert 1957- COL editie VAL 5e, herz. dr	COL titel VAL @Terugkeer naar Angela COL hoofdauteur VAL Konsalik, Heinz G. Konsalik COL 2e auteur VAL Rossum, David van Rossum COL vertaling van VAL Mein Pferd und ich. - München : Lichtenberg, cop. 1973	1
COL titel VAL @Zeven nieuwe verhalen voor de jeugd COL hoofdauteur VAL Schmid, Johann Christoph Friedrich von Schmid 1768-1854 COL editie VAL [6e dr.] COL vertaling van VAL Neue Erzählungen für Kinder und Kinderfreunde, Bd. II. - 1834	COL titel VAL Een @arm... een hoofd... een hart	1
COL titel VAL @Sämmtliche Märchen COL hoofdauteur VAL Andersen, Hans Christian Andersen 1805-1875 COL editie VAL 12 Aufl	COL titel VAL De @trein uit Venetië COL hoofdauteur VAL Simenon, Georges Joseph Christian Simenon 1903-1989 COL 2e auteur VAL Wagensveld, G.J. van Wagensveld COL vertaling van VAL Le train de Venise. - 1965	1
COL titel VAL De @tondeldoos COL hoofdauteur VAL Andersen, Hans Christian Andersen 1805-1875 COL 2e auteur VAL Janssen, Marcus Jacques Agnes Janssen 1974-	COL titel VAL @An en Jan COL ondertitel VAL leesboekjes voor het eerste leerjaar COL hoofdauteur VAL Cramer, Marie Cramer 1887-1977	1
COL titel VAL @Keur uit de drie honderdtallen leerzame verhalen van C. Schmid COL ondertitel VAL een leesboek voor de scholen COL hoofdauteur VAL Schmid, Johann Christoph Friedrich von Schmid 1768-1854 COL 2e auteur VAL Holst, Anthoon Albertus Holst	COL titel VAL @Walt Disney's De Speurneuzen COL 2e auteur VAL Disney, Walter Elias Disney 1901-1966 COL 2e auteur VAL Schröder, Allard Schröder 1946- COL vertaling van VAL The great mouse detective. - Walt Disney Company, cop. 1986	1
COL titel VAL @Keur uit de drie honderdtallen leerzame verhalen van C. Schmid COL ondertitel VAL een leesboek voor de scholen COL hoofdauteur VAL Schmid, Johann Christoph Friedrich von Schmid 1768-1854 COL 2e auteur VAL Holst, Anthoon Albertus Holst COL editie VAL 3e dr	COL titel VAL @Bertus en Bruno COL hoofdauteur VAL Vries, Anne de Vries 1904-1964 COL 2e auteur VAL Hoogendoorn	1
COL titel VAL @Keur uit de drie honderdtallen leerzame verhalen van C. Schmid COL ondertitel VAL een leesboek voor de scholen COL hoofdauteur VAL Schmid, Johann Christoph Friedrich von Schmid 1768-1854 COL 2e auteur VAL Holst, Anthoon Albertus Holst COL editie VAL 5e dr	COL titel VAL De @Vergeet mij niet-sonate COL hoofdauteur VAL Montefiore, Santa Montefiore 1970- COL 2e auteur VAL Rijsewijk, Erica van Rijsewijk COL editie VAL Tweeëntwintigste druk COL vertaling van VAL The forget-me-not sonata. - London : Hodder & Stoughton, 2003	1
COL titel VAL The @mother's picture alphabet COL 2e auteur VAL Anelay, Henry Anelay 1817-1883 COL 2e auteur VAL Stockham, Peter Stockham	COL titel VAL @Mijn Kerst lees- en puzzelboek COL ondertitel VAL met 4 puzzels van 12 stukjes COL 2e auteur VAL Munger, Nancy Munger COL 2e auteur VAL Wijermars, Thera Wijermars	1
COL titel VAL @Vampier in de school COL hoofdauteur VAL Loon, Paulus Stephanus Elisabeth Lambertus Maria van Loon 1955- COL 2e auteur VAL Fialkowski, Camila Fialkowski 1950- COL editie VAL 7e herz. dr COL auteur/primair VAL Loon	COL titel VAL @Wrack unter Wasser COL hoofdauteur VAL Rutgers van der Loeff, Anna Maria Margaretha Rutgers van der Loeff 1910-1990 COL 2e auteur VAL Veen, Fiel van der Veen 1945- COL 2e auteur VAL Knust, Jutta Knust 1956-2017 COL vertaling van VAL Wrak onder water. - 1970	1
COL titel VAL @Kinder- und Hausmärchen der Brüder Grimm COL hoofdauteur VAL Grimm, Jacob Ludwig Carl Grimm 1785-1863 COL 2e auteur VAL Richter, Adrian Ludwig Richter 1803-1884	COL titel VAL @Schipper Wessels COL hoofdauteur VAL Norel, Klaas Norel 1899-1971 COL 2e auteur VAL Hoogendoorn, Gerardus Dominicus Hoogendoorn 1892-1948 COL 2e auteur VAL Wilde, Dirk de Wilde 1905-1994 COL editie VAL 11e dr	1
COL titel VAL @Andersens Märchen COL hoofdauteur VAL Andersen, Hans Christian Andersen 1805-1875 COL 2e auteur VAL Steiner-Prag, Hugo Steiner-Prag 1880-1945	COL titel VAL @Katten COL ondertitel VAL huisvesting, voeding, verzorging	1
COL titel VAL @Dromen van geluk COL hoofdauteur VAL Cookson, Catherine Anne Cookson 1906-1998 COL 2e auteur VAL Mons, Annet Mons COL vertaling van VAL A ruthless need. - London [etc.] : Bantam Press, 1995	COL titel VAL @Hiawatha de grote krijger COL 2e auteur VAL Disney, Walter Elias Disney 1901-1966 COL 2e auteur VAL Ruitenbeek, Simone Ruitenbeek COL editie VAL 2e dr COL vertaling van VAL Little Hiawatha	1
COL titel VAL Het @verzenboek voor de Nederlandsche scholen COL ondertitel VAL kindergedichten van verschillende schrijvers COL 2e auteur VAL Hoofd-onderwijzer, Hoofd-onderwijzer COL editie VAL 4e dr	COL titel VAL Die @Nibelungen COL 2e auteur VAL Herzog, Rudolf Herzog 1869-1943 COL 2e auteur VAL Stassen, Franz Stassen 1869-1949	1
COL titel VAL @Sta eens even stil COL ondertitel VAL een bundel verhalen om met drie oren naar te luisteren COL 2e auteur VAL Kesseler-van der Klauw, An Kesseler-van der Klauw COL 2e auteur VAL Rijnsburger, Ietje Rijnsburger 1952- COL editie VAL 2e dr	COL titel VAL @Poesjes en hondjes	1
COL titel VAL @Spreekwoordenboek voor kinderen	COL titel VAL @Vóór Tegen Atonaal	1
COL titel VAL Het @leven van "Reintje de vos" COL hoofdauteur VAL Louwerse, Pieter Louwerse 1840-1908 COL editie VAL 3e dr	COL titel VAL @Chasseur de tombeaux	1
COL titel VAL @Kluchtspelen voor de Chineesche schimmen geschikt voor kinderen	COL titel VAL @Tafeltje dek je, ezeltje strek je... COL 2e auteur VAL Grimm, Jacob Ludwig Carl Grimm 1785-1863 COL 2e auteur VAL Grimm, Wilhelm Carl Grimm 1786-1859	1
COL titel VAL @Dit zijn wij COL ondertitel VAL leerkrachtenboek COL 2e auteur VAL Norden, Suzanne van Norden 1954- COL 2e auteur VAL Loo, Franka van der Loo COL 2e auteur VAL Ladee, Madeleen Ladee 1946-	COL titel VAL @Lucy's medaillon	1
COL titel VAL @Tijl Uilenspiegel COL ondertitel VAL zijn wonderlijk leven, zijn snaaksche avonturen, zijn boeverijen en snoeverijen, zijn grappen en guitenstreken COL 2e auteur VAL Ramberg, Johann Heinrich Ramberg 1763-1840	COL titel VAL @Modèles des enfans ou traits d'humanité, de piété filiale, d'amour fraternel, et progrès extraordinairos de la part d'enfans de six à douze ans COL ondertitel VAL ouvrage amusant et moral COL 2e auteur VAL Blanchard, Pierre Blanchard 1772-1856	1
COL titel VAL Het @ruime sop COL ondertitel VAL de mooiste verhalen over de watersport COL 2e auteur VAL Jansen-Meijnen, Nanda Jansen-Meijnen COL editie VAL 5e dr	COL titel VAL @Sprookjes van Grimm/ Gebroeders Grimm COL hoofdauteur VAL Grimm, Jacob Ludwig Carl Grimm 1785-1863 COL 2e auteur VAL Grabianski, Janusz Grabianski 1928-1976 COL 2e auteur VAL Messelaar, Gerard Messelaar 1919-1971 COL editie VAL 3e dr	1
COL titel VAL @Groene weelde COL ondertitel VAL de mooiste verhalen over de tuin COL 2e auteur VAL Jansen-Meijnen, Nanda Jansen-Meijnen COL editie VAL 6e dr	COL titel VAL @Hup, Pipje Hazehart COL hoofdauteur VAL Grashoff, Cornelia Johanna Grashoff 1928-2004 COL 2e auteur VAL Veenhoven, Elisabeth Annie Veenhoven 1919-2001	1
COL titel VAL @Bella Italia COL ondertitel VAL de mooiste verhalen over Italië COL 2e auteur VAL Jansen-Meijnen, Nanda Jansen-Meijnen COL editie VAL 4e dr	COL titel VAL @Oom Dagobert en het gouden paleis COL 2e auteur VAL Disney, Walter Elias Disney 1901-1966 COL 2e auteur VAL Panis, Rosemarie Panis COL vertaling van VAL Piscou et le palais d'or. - Parijs : Hachette	1
COL titel VAL @Bolle buiken COL ondertitel VAL de mooiste verhalen over de zwangerschap COL 2e auteur VAL Jansen-Meijnen, Nanda Jansen-Meijnen COL editie VAL 6e dr	COL titel VAL @Blanke Flip en zwarte Fanny COL hoofdauteur VAL Norel, Klaas Norel 1899-1971 COL 2e auteur VAL Baan, Cornelia Catherina van der Baan 1915-1997	1
COL titel VAL @Hete bliksems COL ondertitel VAL de mooiste erotische verhalen COL 2e auteur VAL Voerman, Jaap Voerman COL editie VAL 8e dr	COL titel VAL @Plaatjes en versjes	1
COL titel VAL @Onder de pannen COL ondertitel VAL de mooiste verhalen over (ver)huizen COL 2e auteur VAL Waaijer, Petra Waaijer COL editie VAL 5e dr	COL titel VAL El @ABC de los animales, frutas y flores	1
COL titel VAL De @afgewezen bruid COL hoofdauteur VAL Peters, Karin Peters COL editie VAL 1e dr	COL titel VAL @Kinky COL ondertitel VAL spannende verhalen over vreemde verlangens COL 2e auteur VAL Giphart, Ronald Edgar Giphart 1965- COL 2e auteur VAL Kisling, C.M.L. Kisling 1954-	1
COL titel VAL @Wat staat daar? COL hoofdauteur VAL Kromhout, Rindert Kromhout 1958- COL auteur/primair VAL Kromhout	COL titel VAL @Zijn insigne van Eer werd hun schietschijf!	1
COL titel VAL @Casa Cara COL hoofdauteur VAL Saris, Helena Barbara Wilhelmina Saris 1915-1999 COL editie VAL 1e dr	COL titel VAL @Vlaamse verhalen na 1965 COL 2e auteur VAL Wispelaere, Paul De Wispelaere 1928-2016	1
COL titel VAL @Alleen op de wereld COL hoofdauteur VAL Malot, Hector Henri Malot 1830-1907 COL 2e auteur VAL Willemsen, August Willemsen 1936-2007 COL vertaling van VAL Sans famille. - Paris, 1878 COL auteur/primair VAL Malot	COL titel VAL De @liefste kusjes zijn voor jou COL editie VAL 2e dr	1
COL titel VAL @Vlaamse legenden COL hoofdauteur VAL Zeeuw, Pieter de Zeeuw J.Gzn. 1890-1968 COL 2e auteur VAL Roothciv, Roothciv COL editie VAL 2e dr	COL titel VAL @Kleuterblaadje COL ondertitel VAL geïllustreerd weekblad voor kinderen van 6-10 jaar	1
COL titel VAL @Legenden van Nederland COL hoofdauteur VAL Zeeuw, Pieter de Zeeuw J.Gzn. 1890-1968 COL 2e auteur VAL Roothciv, Roothciv COL editie VAL 2e dr	COL titel VAL @Pietje Bell is weer aan de gang COL hoofdauteur VAL Abkoude, Christiaan Frederik van Abkoude 1880-1960 COL 2e auteur VAL Straaten, Gerard van Straaten 1924-2011	1
COL titel VAL @Hoe ziet de hemel eruit, God? COL 2e auteur VAL Utters-Adam, Adelheid Utters-Adam COL 2e auteur VAL Neyhoff, Henriëtte J. Neyhoff COL vertaling van VAL Kinder schreiben an den lieben Gott. - München : Mosaik Verlag, 1997	COL titel VAL @Waarom niet tevreden? COL 2e auteur VAL Johanna, Johanna COL editie VAL 2e dr	1
COL titel VAL @Willem Tell COL ondertitel VAL de Zwitsersche vrijheidsheld COL ondertitel VAL oorspronkelijk geschiedkundig verhaal uit het begin der 14e eeuw COL hoofdauteur VAL Louwerse, Pieter Louwerse 1840-1908 COL editie VAL 3e druk	COL titel VAL @Assepoester COL 2e auteur VAL Lagarde, Luce Andrée Lagarde	1
COL titel VAL @Legenden COL ondertitel VAL nieuwe verhalen van de meesters van de fantasy COL 2e auteur VAL Silverberg, Robert Silverberg 1935- COL 2e auteur VAL Ruitenberg, Josephine Ruitenberg 1961- COL vertaling van VAL Legends. - London : Voyager, 1998	COL titel VAL @Anna Karenina COL hoofdauteur VAL Tolstoj, L.N. Tolstoj 1828-1910 COL 2e auteur VAL Leclee, Jacob Leclée COL editie VAL Tiende druk COL vertaling van VAL Anna Karenina. - 1876	1
COL titel VAL @Udvalgte eventyr COL hoofdauteur VAL Andersen, Hans Christian Andersen 1805-1875 COL 2e auteur VAL Pedersen, Thomas Vilhelm Pedersen 1820-1859	COL titel VAL @Maigret en de familie Peeters COL hoofdauteur VAL Simenon, Georges Joseph Christian Simenon 1903-1989 COL 2e auteur VAL Romijn, Karel Hendrik Romijn COL editie VAL [Herd.] COL vertaling van VAL Chez les Flamands. - 1932	1
COL titel VAL @Letta's bestemming COL hoofdauteur VAL Burgers-Drost, Julia Eveline Jolanda Burgers-Drost 1938-2013	COL titel VAL Het @verhaal van Heer Vos COL hoofdauteur VAL Potter, Helen Beatrix Potter 1866-1943 COL 2e auteur VAL Vogel, Herma Vogel COL vertaling van VAL The tale of Mr. Tod. - London : Warne, cop. 1993. - Oorspr. Engelse uitg.: London : Warne, 1912	1
COL titel VAL @Little men COL ondertitel VAL life at Plumfield with Jo's boys COL hoofdauteur VAL Alcott, Louisa May Alcott 1832-1888 COL editie VAL one hundred and thirteenth thousand	COL titel VAL @Hans Fortuin COL hoofdauteur VAL Grimm, Jacob Ludwig Carl Grimm 1785-1863	1
COL titel VAL @Little men COL ondertitel VAL life at Plumfield with Jo's boys COL hoofdauteur VAL Alcott, Louisa May Alcott 1832-1888	COL titel VAL @Alleen op de wereld COL hoofdauteur VAL Malot, Hector Henri Malot 1830-1907 COL 2e auteur VAL Ibarro Montilla, A. Ibarra	1
COL titel VAL @Little Women COL ondertitel VAL a story for girls COL hoofdauteur VAL Alcott, Louisa May Alcott 1832-1888	COL titel VAL Het @schaapje COL 2e auteur VAL Stolarczyk, Monika Stolarczyk COL 2e auteur VAL Stolarczyk, Dariusz Stolarczyk	1
COL titel VAL @Alleen op de wereld COL hoofdauteur VAL Malot, Hector Henri Malot 1830-1907 COL 2e auteur VAL Panis, Rosemarie Panis COL 2e auteur VAL Bayard, Émile Antoine Bayard 1837-1891 COL vertaling van VAL Sans famille. - Paris, 1878	COL titel VAL @Prins Blauwert COL hoofdauteur VAL Bel, Marc De Bel 1954- COL 2e auteur VAL Bosschaert, Jan Bosschaert 1957-	1
COL titel VAL @Dochters COL ondertitel VAL verhalen over hun moeders COL 2e auteur VAL Spoor, Hendrickje Elisabeth Hedwig Spoor 1963- COL editie VAL 2e dr	COL titel VAL @Grondwet voor het Koninkrijk der Nederlanden COL ondertitel VAL tekst-uitgave, door de aanwending van verschillend lettertype, voor schoolgebruik en studie meer geschikt gemaakt	1
COL titel VAL @Vaders COL ondertitel VAL verhalen van hun dochters COL 2e auteur VAL Durlacher, Jessica Durlacher 1961- COL editie VAL 3e dr	COL titel VAL @Vreemden COL 2e auteur VAL Zoer, A.B. Zoer	1
COL titel VAL De @genezing van de krekel COL hoofdauteur VAL Tellegen, Antonius Otto Hermannus Tellegen 1941- COL auteur/primair VAL Tellegen	COL titel VAL @Wonderbaarlyke en zeldzame historie, van Thyl Ulenspiegel, van zijn schalke, listige potzen en boeveryen, die hy zoo in zyn dood als ook in zyn leven bedreeven heeft COL ondertitel VAL zeer teydkortig en geneuglyk om te leezen. COL ondertitel VAL Voor ouden en jongen lieden	1
COL titel VAL @Mijn kind COL ondertitel VAL de mooiste verhalen over zwangerschap, bevalling en ouderinstinct COL 2e auteur VAL Durlacher, Jessica Durlacher 1961- COL editie VAL 2e dr	COL titel VAL @Ottelientje COL hoofdauteur VAL Hagers, Freddy Hagers COL 2e auteur VAL Leeuwen, Ferdinanda Emilia van Leeuwen 1900-1995 COL 2e auteur VAL Veenhoven, Elisabeth Annie Veenhoven 1919-2001 COL editie VAL 3e dr	1
COL titel VAL @Zonen COL ondertitel VAL verhalen over hun vaders COL 2e auteur VAL Oberski, Arnan Oberski 1963- COL editie VAL 2e dr	COL titel VAL @Star of peace COL hoofdauteur VAL Hartog, Johannes de Hartog 1914-2002 COL editie VAL First Signet printing COL Gedeeltelijke bewerking van het toneelstuk VAL Skipper next to God	1
COL titel VAL @Geluk is als de wind COL hoofdauteur VAL Thijssing-Boer, Henny Thijssing-Boer 1933-2011 COL editie VAL 1e dr	COL titel VAL Het @visitekaartje of broeder en zuster COL 2e auteur VAL Burg, Maria Burg fl. 1908-1925	1
COL titel VAL @Kinderliedjes uit Zonneland COL hoofdauteur VAL Cramer, Marie Cramer 1887-1977	COL titel VAL @Muis gaat naar de maan COL ondertitel VAL draai, schuif en speel! COL hoofdauteur VAL Cousins, Elizabeth Cousins 1964- COL editie VAL Eerste druk COL vertaling van VAL Maisy's moon mission. - London : Walker Books Ltd., ©2021	1
COL titel VAL Het @vervelende lieveheersbeestje COL hoofdauteur VAL Carle, Eric Carle 1929-2021 COL 2e auteur VAL Moorselaar, Corinne van Moorselaar COL vertaling van VAL The grouchy ladybug. - New York : HarperCollins, cop. 1977	COL titel VAL Een @Heer in de kracht van zijn leven! COL hoofdauteur VAL Toonder, Marten Toonder 1912-2005 COL editie VAL 2e dr COL auteur/primair VAL Toonder	1
COL titel VAL @Ich widerspreche stets COL ondertitel VAL das unbändige Leben der Gräfin Bentinck COL ondertitel VAL Roman COL hoofdauteur VAL Haasse, Hélène Serafia Haasse 1918-2011 COL 2e auteur VAL Csollány, Maria Csollány 1932- COL vertaling van VAL Mevrouw Bentinck, of, Onverenigbaarheid van karakter : een ware geschiedenis. - Amsterdam : Querido, 1978	COL titel VAL @Wie zingt mee? COL ondertitel VAL goede bekenden voor de Zondagsschool COL 2e auteur VAL Marang, Gerardus Pieter Marang 1875-1948 COL 2e auteur VAL Post, L.C. Post COL editie VAL 2e dr	1
COL titel VAL @Floortje Bellefleur en het dorpsfeest COL hoofdauteur VAL Grashoff, Cornelia Johanna Grashoff 1928-2004 COL 2e auteur VAL Behrens, Marijke Behrens	COL titel VAL @Keluarga sirkus COL ondertitel VAL penembak jitu	1
COL titel VAL Een @vader voor altijd COL ondertitel VAL de mooiste verhalen over vaders COL 2e auteur VAL Jansen, Mechteld Jansen	COL titel VAL Het @geheim van de witte bison COL hoofdauteur VAL May, Karl Friedrich May 1842-1912 COL 2e auteur VAL Bogaard, Dick L. Uyt den Bogaard COL 2e auteur VAL Kresse, Hans Georg Kresse 1921-1992 COL editie VAL 10e dr COL vertaling van VAL Unter Geiern. - 1890	1
COL titel VAL @Aladdin en de wonderlamp COL ondertitel VAL uit 1001 nacht-vertellingen COL hoofdauteur VAL Hildebrand, Annettes Dideric Hildebrand 1907-1977 COL 2e auteur VAL Nieuwenhoven, Willem van Nieuwenhoven 1913-1989 COL editie VAL [Herdr.]	COL titel VAL @Floortje Bellefleur gaat op kamp COL hoofdauteur VAL Grashoff, Cornelia Johanna Grashoff 1928-2004 COL 2e auteur VAL Behrens, H.G.M. Behrens 1937- COL editie VAL 2e dr	1
COL titel VAL @Als een bloem in de knop COL hoofdauteur VAL Cookson, Catherine Anne Cookson 1906-1998 COL 2e auteur VAL Mons, Annet Mons COL editie VAL [5e dr.] COL vertaling van VAL The house of women. - London [etc.] : Bantam Press, 1992	COL titel VAL @Wil je mijn vriendje zijn? COL hoofdauteur VAL Carle, Eric Carle 1929-2021 COL editie VAL 3e dr COL vertaling van VAL Die kleine Maus sucht ein Freund. - Oldenburg : Stalling	1
COL titel VAL A @Christmas carol COL hoofdauteur VAL Dickens, Charles John Huffam Dickens 1812-1870 COL 2e auteur VAL Rackham, Arthur Rackham 1867-1939 COL editie VAL 9e dr	COL titel VAL @Alle klokken luiden COL ondertitel VAL een bundel novellen, impressies, interviews, schetsen, verzen en muziek COL 2e auteur VAL Coolen, Antonius Franciscus Coolen 1897-1961 COL editie VAL 2e dr	1
COL titel VAL @Dikkie Dik COL ondertitel VAL het dikkerdandikke avonturenboek COL hoofdauteur VAL Boeke, Henriëtte Boeke 1948- COL 2e auteur VAL Norden, Arthur van Norden 1947- COL editie VAL 1e dr	COL titel VAL @Rotbeesten COL hoofdauteur VAL Dahl, Roald Dahl 1916-1990 COL 2e auteur VAL Blake, Quentin Saxby Blake 1932- COL 2e auteur VAL Vriesendorp, Gerarde Hubèrte Vriesendorp 1940- COL editie VAL Zevende druk COL vertaling van VAL Dirty beasts. - London : Jonathan Cape Ltd, 1983	1
COL titel VAL @Cat among the pigeons COL hoofdauteur VAL Christie, Agatha Christie 1890-1976	COL titel VAL Het @dagboek van Zwarte Piet COL hoofdauteur VAL De Bel, Marc De Bel 1954- COL 2e auteur VAL Straaten, Harmen van Straaten 1961-	1
COL titel VAL @Verwoeste zielen COL hoofdauteur VAL Konsalik, Heinz G. Konsalik COL 2e auteur VAL Amerongen, Jan van Amerongen 1939-1998 COL vertaling van VAL Der Herr der zerstörten Seelen. - München : AVA, cop. 1997	COL titel VAL @Josientje en de poppenkast COL hoofdauteur VAL Grashoff, Cornelia Johanna Grashoff 1928-2004 COL 2e auteur VAL Giffen, Rudy van Giffen 1929-2005 COL editie VAL [3e dr.]	1
COL titel VAL Het @grote liedjesboek COL hoofdauteur VAL Busser, Marianne Busser 1958-2025 COL 2e auteur VAL Steen, Wilhelmus Gijsbertus Henricus Maria van der Steen 1966- COL editie VAL 2e dr COL auteur/primair VAL Busser	COL titel VAL ...@En wat kan ik? COL ondertitel VAL jeugdroman COL hoofdauteur VAL Diekmann, Maria Hendrika Jozina Diekmann 1925-2017 COL 2e auteur VAL Borrebach, Henri Carl Johan Elisa Borrebach 1903-1991	1
COL titel VAL @Rikki COL hoofdauteur VAL Genechten, Guido Van Genechten 1957- COL auteur/primair VAL Van Genechten	COL titel VAL @Cerita rakyat Jawa Barat COL 2e auteur VAL Suparlan, Y.B. Suparlan 1934-	1
COL titel VAL @Karel in het vliegtuig COL hoofdauteur VAL Slegers, Liesbet Slegers 1975-	COL titel VAL @Fulco van Bern COL ondertitel VAL schetsen uit de geschiedenis van Noordbrabant COL 2e auteur VAL Hezenmans, Johannes Cornelius Antonius Hezenmans 1833-1909	1
COL titel VAL @Karel in het ziekenhuis COL hoofdauteur VAL Slegers, Liesbet Slegers 1975-	COL titel VAL @A.B.C	1
COL titel VAL @Karel gaat naar school COL hoofdauteur VAL Slegers, Liesbet Slegers 1975- COL auteur/primair VAL Slegers	COL titel VAL @Wie ben jij? COL hoofdauteur VAL Bruna, Hendrik Magdalenus Bruna 1927-2017	1
COL titel VAL @Kinder kijk- en luisterboek COL 2e auteur VAL Richardson, Frederick Richardson 1862-1937 COL 2e auteur VAL Meys, Meentje Meys COL 2e auteur VAL Hunt, Irene Hunt 1907-2001 COL editie VAL 2e dr COL vertaling van VAL Great children's stories. - Rand McNally, cop. 1977	COL titel VAL @Oetje Veldhuizen COL ondertitel VAL en andere verhalen COL 2e auteur VAL Kok COL 2e auteur VAL Andriessen COL 2e auteur VAL Abramsz	1
COL titel VAL De @geest COL hoofdauteur VAL Steel, Danielle Fernande Steel 1947- COL 2e auteur VAL Duzee, Lucien Antoine Duzee 1943-2016 COL vertaling van VAL The ghost. - New York : Delacorte Press, 1997 COL auteur/primair VAL Steel	COL titel VAL Het @standvastige tinnen soldaatje COL 2e auteur VAL Andersen, Hans Christian Andersen 1805-1875	1
COL titel VAL Een @zomerzotheid COL hoofdauteur VAL Marxveldt, Cissy van Marxveldt 1889-1948 COL 2e auteur VAL Borrebach, Henri Carl Johan Elisa Borrebach 1903-1991 COL 2e auteur VAL Luttge, Jacob Martinus Luttge 1904-1989 COL editie VAL 2e dr	COL titel VAL @Alleen op de wereld COL hoofdauteur VAL Malot, Hector Henri Malot 1830-1907 COL 2e auteur VAL Bayard, Émile Antoine Bayard 1837-1891 COL vertaling van VAL Sans famille. - Paris, 1878	1
COL titel VAL Een @zomerzotheid COL hoofdauteur VAL Marxveldt, Cissy van Marxveldt 1889-1948 COL 2e auteur VAL Borrebach, Henri Carl Johan Elisa Borrebach 1903-1991 COL editie VAL 15e dr	COL titel VAL @Meren en dammen COL 2e auteur VAL Jong, Meindert de Jong 1913- COL 2e auteur VAL Anderson, F. Anderson	1
COL titel VAL @Baby's woordenboek COL ondertitel VAL voor kinderen van 1 tot 3 jaar COL Eerder verschenen in VAL Baby's woordenboek : voor baby's van 18-36 maanden	COL titel VAL @Laat de kindertjes tot mij komen COL ondertitel VAL want dezulken is het rijk Gods COL editie VAL Vierde druk	1
COL titel VAL Het @kleine museum COL 2e auteur VAL Le Saux, Alain Le Saux 1936- COL 2e auteur VAL Solotareff, Grégoire Solotareff 1953- COL editie VAL 3e dr COL vertaling van VAL Petit musée. - Paris : L'Ecole des Loisirs, 1992	COL titel VAL Een @monnik dartelt in bloemenhoven COL ondertitel VAL benevens de verdere lotgevallen van Hsi Men's vrouwen COL ondertitel VAL naar een Chineesche familiekroniek uit de 12e eeuw COL 2e auteur VAL Kelk, Cornelis Jan Kelk 1901-1981 COL 2e auteur VAL Kuhn, Franz Walther Kuhn 1884-1961 COL 2e auteur VAL Holman, Léon Holman	1
COL titel VAL Die @Prozedur COL ondertitel VAL Roman COL hoofdauteur VAL Mulisch, Harry Kurt Victor Mulisch 1927-2010 COL 2e auteur VAL Seferens, Gregor Seferens 1964- COL vertaling van VAL De procedure. - Amsterdam : Bezige Bij, 1998	COL titel VAL @Hoor je dat, Dribbel? COL ondertitel VAL Dribbels grote geluidenboek COL hoofdauteur VAL Hill, Eric Hill 1927-2014 COL vertaling van VAL What's that noise, Spot? - London : Warne, cop. 2010	1
COL titel VAL @Shangri-la COL ondertitel VAL 16 verhalen uit het verloren paradijs van o.a. Tanith Lee, Orson Scott Card, David Drake & Roger Zelazny COL 2e auteur VAL Marigny, E.L. de Marigny COL 2e auteur VAL Martijn, Jaime Martijn COL 2e auteur VAL Lee, Tanith Lee 1947-	COL titel VAL @Vuurvliegjes, tovervisjes en schatgravers COL ondertitel VAL lezen, zingen, spelen en knutselen met water, aarde, lucht en vuur COL 2e auteur VAL Klaassen, Sandra Klaassen 1959- COL 2e auteur VAL Donkelaar, Maria van Donkelaar 1947- COL 2e auteur VAL Rooijen, Martine van Rooijen COL editie VAL 2e dr COL Oorspr. titel VAL Tovervisjes, vuurvliegjes en schatgravers. - 2000	1
COL titel VAL @Naar het middelpunt der aarde COL hoofdauteur VAL Verne, Jules Gabriel Verne 1828-1905 COL vertaling van VAL Voyage au centre de la terre	COL titel VAL @Voorval COL ondertitel VAL variatie op een thema COL hoofdauteur VAL Mulisch, Harry Kurt Victor Mulisch 1927-2010 COL auteur/primair VAL Mulisch	1
COL titel VAL @Wat is natuur nog in dit land COL ondertitel VAL de mooiste Nederlandse tuinverhalen en -gedichten COL 2e auteur VAL Engelen, Margot Engelen 1957- COL editie VAL 2e dr	COL titel VAL De @kaboutertjes	1
COL titel VAL @Alle dagen dierendag COL 2e auteur VAL Kuyper, Hans Ewout Kuyper 1962-	COL titel VAL Een @schrale troost COL ondertitel VAL verhalen van vrouwen over mannen COL 2e auteur VAL Stamperius, Johanna Maria Jelles Stamperius 1943-2022	1
COL titel VAL @Morgen mag ik in het diepe... COL hoofdauteur VAL Slee, Carry Slee 1949- COL 2e auteur VAL Stam, Dagmar Stam 1945- COL editie VAL 14e [aangepaste] dr	COL titel VAL De @avonturen van Reinaard de vos	1
COL titel VAL De @H.B.S. tijd van Joop ter Heul COL hoofdauteur VAL Marxveldt, Cissy van Marxveldt 1889-1948 COL 2e auteur VAL Mens, Isidorus Maria Cornelis van Mens 1890-1985 COL editie VAL 10e dr	COL titel VAL @Taras Bulba COL 2e auteur VAL Gogol, Nikolaj Vasilʹevič Gogolʹ 1809-1852	1
COL titel VAL @Joop en haar jongen COL hoofdauteur VAL Marxveldt, Cissy van Marxveldt 1889-1948 COL 2e auteur VAL Borrebach, Henri Carl Johan Elisa Borrebach 1903-1991 COL editie VAL 12e dr	COL titel VAL @Is zij schuldig? COL ondertitel VAL geen genade voor Sandra	1
COL titel VAL De @toekomst van Marijke COL hoofdauteur VAL Marxveldt, Cissy van Marxveldt 1889-1948 COL 2e auteur VAL Borrebach, Henri Carl Johan Elisa Borrebach 1903-1991 COL editie VAL 3 dr COL Vervolg van VAL Marijke COL Wordt vervolgd door VAL Marijke's bestemming	COL titel VAL De @koningskinderen en andere verhalen COL 2e auteur VAL Blaauw, Henriëtte Blaauw 1875-1949 COL 2e auteur VAL Noorden, Franciscus Martinus van Noorden 1887-1961	1
COL titel VAL @Woorden dansen in mijn hoofd COL ondertitel VAL wie... waait... over... het... land... de woordenwind COL 2e auteur VAL Vaessen, Iet Vaessen	COL titel VAL @Winnetou, het grote Apachenopperhoofd COL hoofdauteur VAL May, Karl Friedrich May 1842-1912 COL 2e auteur VAL Gils, E.W.M. van Gils COL vertaling van VAL Winnetou. - Bamberg : Karl-May-Verlag, ca. 1892 COL Nederlandse uitg. eerder verschenen o.d.t. VAL Winnetou, het grote opperhoofd. - Utrecht : Het Spectrum, 1962. - (Karl May-pockets)	1
COL titel VAL @Brandend zand COL ondertitel VAL erotische zonverhalen voor vrouwen COL 2e auteur VAL Punter, Monique Punter 1965-2007 COL editie VAL 2e dr	COL titel VAL De @noodzaak COL hoofdauteur VAL King, Stephen Edwin King 1947- COL 2e auteur VAL Essen, Rein van Essen COL vertaling van VAL Needful things. - New York : Viking, cop. 1991 COL auteur/primair VAL King	1
COL titel VAL @Avonturen van drie Russen en drie Engelsen COL ondertitel VAL gevolgd door De blokkadebrekers COL hoofdauteur VAL Verne, Jules Gabriel Verne 1828-1905 COL 2e auteur VAL Wiegman, Johannes Petrus Antonius Wiegman 1884-1963 COL vertaling van VAL Aventures de trois Russes et de trois Anglais dans l'Afrique australe. - 1870	COL titel VAL De @Saint en het levende lijk COL hoofdauteur VAL Charteris, Leslie Charteris 1907-1993 COL 2e auteur VAL Havank, Havank COL vertaling van VAL Le Saint se bat contre un fantôme	1
COL titel VAL De @storm van de eeuw COL hoofdauteur VAL King, Stephen Edwin King 1947- COL 2e auteur VAL Kuipers, Hugo Kuipers 1954-2013 COL vertaling van VAL Storm of the century	COL titel VAL @Van zes uur 's avonds tot twee uur 's nachts COL hoofdauteur VAL Roggeveen, Leonard Roggeveen 1898-1959 COL 2e auteur VAL Thomassen, Marius Jacques Gérard Thomassen 1918-1971 COL Ook verschenen o.d.t. VAL Geheimzinnige druppels	1
COL titel VAL Het @geheimzinnige eiland COL ondertitel VAL de verlatene COL hoofdauteur VAL Verne, Jules Gabriel Verne 1828-1905 COL vertaling van VAL L'île mystérieuse. - 1874	COL titel VAL @Rabelais pour le XXIe siècle COL ondertitel VAL actes du colloque du Centre d'Études Supérieures de la Renaissance (Chinon-Tours, 1994) COL 2e auteur VAL Simonin, Michel Simonin 1947-2000	1
COL titel VAL De @reis om de wereld in tachtig dagen COL hoofdauteur VAL Verne, Jules Gabriel Verne 1828-1905 COL vertaling van VAL Le tour du monde en quatre-vingt jours. - 1872	COL titel VAL @Verloren zoon COL ondertitel VAL een geheim overschaduwt de band tussen twee broers COL hoofdauteur VAL Steel, Danielle Fernande Steel 1947- COL 2e auteur VAL Visser, Lara Visser COL editie VAL Derde druk COL vertaling van VAL Prodigal son. - Londen : Bantam Press, 2015	1
COL titel VAL Het @verleden reist mee COL hoofdauteur VAL Burgers-Drost, Julia Eveline Jolanda Burgers-Drost 1938-2013	COL titel VAL De @kluchtige aap en het poesje COL 2e auteur VAL Müller, Johan Frederik Lodewijk Muller 1800-1869 COL editie VAL 5e dr COL vertaling van VAL The monkey's frolic. - 1823 (Lust en Leering)	1
COL titel VAL De @Aquitaine samenzwering COL hoofdauteur VAL Ludlum, Robert Ludlum 1927-2001 COL 2e auteur VAL Bruning, Frans J. Bruning COL editie VAL 12e dr COL vertaling van VAL The Aquitaine progression. - New York : Random House, 1984	COL titel VAL @Collega ontvoerd COL ondertitel VAL waarom verdween zij spoorloos	1
COL titel VAL Het @Jason dubbelspel COL hoofdauteur VAL Ludlum, Robert Ludlum 1927-2001 COL 2e auteur VAL Bruning, Frans J. Bruning COL editie VAL 15e dr COL vertaling van VAL The Bourne supremacy. - New York : Random House, 1986 COL Vervolg op VAL Het Bourne bedrog	COL titel VAL @Twintigtal zedekundige prentverbeeldingen, voor de jeugd	1
COL titel VAL De @groten der aarde COL ondertitel VAL ontdekkers, uitvinders, wetenschapsmensen, weldoeners der mensheid, komponisten, dichters en kunstenaars van alle tijden en van alle landen COL 2e auteur VAL Arnoldus, Johannes Hendrikus Willem Arnoldus 1919-2002 COL 2e auteur VAL Popp, Georg Popp 1928-2004 COL 2e auteur VAL Vermeiren, Jozef Leopold Vermeiren 1914-2005 COL 2e auteur VAL Elders, J.J.L. Elders COL 2e auteur VAL Gelbhaar, Klaus Gelbhaar COL 2e auteur VAL Stiphout, Stef Van Stiphout 1931- COL vertaling van VAL Die Grossen der Welt. -  Würzburg : Arena Verlag	COL titel VAL @Zusje leesgraag COL ondertitel VAL verhalen en versjes voor jongens en meisjes COL 2e auteur VAL _, Cora, Cora COL 2e auteur VAL Doorman, Christina Doorman 1858-1941	1
COL titel VAL @Op je bordje COL vertaling van VAL Food. - London : Dorling Kindersley, cop. 1999. - (Scratch and sniff)	COL titel VAL @Mijn slaapverhaaltjes doosje COL 2e auteur VAL Deverell, Christine Deverell COL 2e auteur VAL Deverell, Richard Deverell	1
COL titel VAL @Toen kwam jij, Annemarie! COL hoofdauteur VAL Saris, Helena Barbara Wilhelmina Saris 1915-1999 COL 2e auteur VAL Herson, Herson COL editie VAL [Herdr.]	COL titel VAL Het @gouden vogeltje	1
COL titel VAL @Lente nocturne COL hoofdauteur VAL Saris, Helena Barbara Wilhelmina Saris 1915-1999 COL 2e auteur VAL Herson, Herson	COL titel VAL @Joël & Brainwash COL hoofdauteur VAL Slee, Carry Slee 1949-	1
COL titel VAL @Dikkie Dik COL ondertitel VAL het oranje blokboekje COL hoofdauteur VAL Boeke, Henriëtte Boeke 1948- COL 2e auteur VAL Norden, Arthur van Norden 1947- COL editie VAL 1e dr	COL titel VAL @Nieuwe rijmpjes COL hoofdauteur VAL Cramer, Marie Cramer 1887-1977 COL editie VAL 3e dr	1
COL titel VAL @Dikkie Dik COL ondertitel VAL het roze blokboekje COL hoofdauteur VAL Boeke, Henriëtte Boeke 1948- COL 2e auteur VAL Norden, Arthur van Norden 1947- COL editie VAL 1e dr	COL titel VAL @Setuwo the tiger COL hoofdauteur VAL Fabricius, Johan Johannes Fabricius 1899-1981 COL 2e auteur VAL Edwards, Roy Edwards 1931- COL vertaling van VAL Setoewo de tijger. - 's-Gravenhage : Leopold, 1956	1
COL titel VAL De @genoegens van het landleven COL 2e auteur VAL Polders, Loek Polders COL editie VAL 1e dr	COL titel VAL @Verzenbundel COL ondertitel VAL voordrachtjes, versjes, samenspraken, liedjes enz. voor allerlei feesten op school en thuis COL 2e auteur VAL Zuster van Liefde van O.L. Vrouw, Moeder van Barmhartigheid	1
COL titel VAL Het @meisje Jennifer COL hoofdauteur VAL Thijssing-Boer, Henny Thijssing-Boer 1933-2011 COL Vervolg op VAL Het teken van een vreemdeling	COL titel VAL Het @tweede boek van Dik Trom en zijn dorpsgenoten COL hoofdauteur VAL Kieviet, Cornelis Johannes Kieviet 1858-1931 COL 2e auteur VAL Braakensiek, Johan Coenraad Braakensiek 1858-1940 COL editie VAL 27e dr	1
COL titel VAL De @onverwachte erfenis COL hoofdauteur VAL Burgers-Drost, Julia Eveline Jolanda Burgers-Drost 1938-2013 COL auteur/primair VAL Burgers-Drost	COL titel VAL @Er is een weg naar morgen COL hoofdauteur VAL Graaf, Anke de Graaf 1927-2019 COL auteur/primair VAL Graaf	1
COL titel VAL @Geld alleen brengt geen geluk COL hoofdauteur VAL Peters, Karin Peters	COL titel VAL @Sprookjes van alle tijden COL hoofdauteur VAL Andersen, Hans Christian Andersen 1805-1875 COL 2e auteur VAL Disman, Miloslav Disman COL 2e auteur VAL Vesting, Anna Vesting COL vertaling van VAL Hans Christian Andersen: Märchen. - Oorspr. titel: H. C. Andersens Eventyr og historier. - Praha : Brio, 1995 COL auteur/primair VAL Andersen	1
COL titel VAL @Streling voor het oog COL hoofdauteur VAL Rendell, Ruth Rendell 1930-2015 COL 2e auteur VAL Kuipers, Hugo Kuipers 1954-2013 COL editie VAL 1e dr COL vertaling van VAL A sight for sore eyes. - London : Hutchinson, 1998	COL titel VAL @Mijn eerste alfabet boek	1
COL titel VAL @Onvergetelijke sprookjes COL 2e auteur VAL Lopez Ramon, Juan Lopez Ramon	COL titel VAL @Met eere verloren COL ondertitel VAL een verhaal uit onze vaderlandsche geschiedenis COL hoofdauteur VAL Louwerse, Pieter Louwerse 1840-1908 COL editie VAL 2e dr	1
COL titel VAL @Ongrijpbaar als de wind COL hoofdauteur VAL Peters, Karin Peters COL editie VAL 1e dr COL auteur/primair VAL Peters	COL titel VAL Le @melon, suivi du Rossignol COL hoofdauteur VAL Schmid, Johann Christoph Friedrich von Schmid 1768-1854 COL vertaling van VAL Die Melone; Die Nachtigall	1
COL titel VAL @Als de geur van toverbloesem COL hoofdauteur VAL Konsalik, Heinz G. Konsalik COL 2e auteur VAL Wit, Jan de Wit COL editie VAL 3e dr COL vertaling van VAL Wie ein Hauch von Zauberblüten. - München : Bertelsmann, 1981	COL titel VAL @Prijs voor Eindhovens schrijftalent COL 2e auteur VAL Morre, Merel Morre 1977-	1
COL titel VAL De @dochter des huizes COL hoofdauteur VAL Cookson, Catherine Anne Cookson 1906-1998 COL 2e auteur VAL Mons, Annet Mons COL editie VAL 3e dr COL vertaling van VAL The upstart. - London [etc.] : Bantam Press, 1996	COL titel VAL Het @hoe en waarom van alledaagse dingen COL 2e auteur VAL Becker, Paul De Becker	1
COL titel VAL Een @nieuwer testament COL hoofdauteur VAL Haasse, Hélène Serafia Haasse 1918-2011 COL editie VAL 6e dr	COL titel VAL @Schuld en boete (Raskolnikow) COL hoofdauteur VAL Dostojewsky, Fedor Michajlovič Dostoevskij 1821-1881 COL 2e auteur VAL Kuknos, Petros Kuknos COL editie VAL 2e goedkope druk COL vertaling van VAL Prestuplenie i nakazanie. - 1866	1
COL titel VAL @Richtig dicke Freunde COL hoofdauteur VAL Tellegen, Antonius Otto Hermannus Tellegen 1941- COL 2e auteur VAL Oeser, Wiebke Oeser 1967- COL 2e auteur VAL Pressler, Mirjam Pressler 1940-2019 COL editie VAL [1. Aufl.] COL vertaling van VAL Toen niemand iets te doen had. - Amsterdam : Querido, 1987	COL titel VAL @Sprookjesschat COL 2e auteur VAL Hart, Dirk Hart 1898-1986	1
COL titel VAL De @schaduw van het geheim COL hoofdauteur VAL Graaf, Anke de Graaf 1927-2019	COL titel VAL @Boze opzet COL hoofdauteur VAL Steel, Danielle Fernande Steel 1947- COL 2e auteur VAL Benink, Carla Benink COL vertaling van VAL Malice. - London [etc.] : Bantam Press, 1996 COL auteur/primair VAL Steel	1
COL titel VAL @Pippi Langkous COL ondertitel VAL met al haar kleurige avonturen in één groot boek vol tekeningen van Carl Hollander COL hoofdauteur VAL Lindgren, Astrid Anna Emilia Lindgren 1907-2002 COL 2e auteur VAL Hollander, Carl Nicolaas Hollander 1934-1995 COL 2e auteur VAL Borgesius-Wildschut, Elizabeth Henderika Wildschut 1914-1989 COL editie VAL 13e dr	COL titel VAL Het @ABC COL ondertitel VAL 26 aardige rijmpjes voor kinderen van 5-10 jaar	1
COL titel VAL @Moorddadig menu COL 2e auteur VAL Dahl, Roald Dahl 1916-1990 COL 2e auteur VAL Kuyper, Mariëlla Snel COL vertaling van VAL Murder on the menu. - New York : Avon, 1984	COL titel VAL @Poppy Pig goes to market COL hoofdauteur VAL Bruna, Hendrik Magdalenus Bruna 1927-2017	1
COL titel VAL @Mijn eerste groot dierenboek COL 2e auteur VAL _, Wang, Wang Shu-Jing COL 2e auteur VAL _, Chang, Chang Yi-Wen COL 2e auteur VAL _, Lin, Lin Chun-Chun COL 2e auteur VAL Boer, Ineke de Boer	COL titel VAL Het @leven van Napoleon COL ondertitel VAL geschiedkundig verhaal voor de Nederlandsche jeugd COL editie VAL Vierde, op nieuw bewerkte druk	1
COL titel VAL De @schaapherder van Montcontour COL ondertitel VAL een verhaal uit het leven van Gaspard de Coligny COL hoofdauteur VAL Zeeuw, Pieter de Zeeuw J.Gzn. 1890-1968 COL 2e auteur VAL _, Menno, Menno COL editie VAL 3e dr	COL titel VAL The @lamb's war COL hoofdauteur VAL Hartog, Johannes de Hartog 1914-2002 COL editie VAL First Fawcett Crest edition	1
COL titel VAL De @mooiste sprookjes	COL titel VAL @Groot prentenboek uit grootmoeders jeugd COL 2e auteur VAL Vries, Leonard de Vries 1919-2002	1
COL titel VAL @Broertjes en zusjes	COL titel VAL The @complete fairy tales and stories COL hoofdauteur VAL Andersen, Hans Christian Andersen 1805-1875 COL 2e auteur VAL Haugaard, Erik Christian Haugaard 1923-2009	1
COL titel VAL @Scheepsmaat Woeltje COL hoofdauteur VAL Norel, Klaas Norel 1899-1971 COL 2e auteur VAL Hoogendoorn, Gerardus Dominicus Hoogendoorn 1892-1948 COL editie VAL 2e dr COL Wordt vervolgd door VAL Stuurman Aart	COL titel VAL Het @scheepswrak COL 2e auteur VAL Thelwell, David Thelwell	1
COL titel VAL @Mijn eerste woordjes COL ondertitel VAL glitter-boekje	COL titel VAL @Van oude mensen, de dingen die voorbijgaan COL hoofdauteur VAL Couperus, Louis Marie Anne Couperus 1863-1923 COL editie VAL 1e dr COL Oorspr. uitg. o.d.t. VAL Van oude menschen, de dingen, die voorbijgaan.... -  Amsterdam : Veen, 1906	1
COL titel VAL @Circus COL ondertitel VAL de grootste show op aarde COL ondertitel VAL verhalen COL 2e auteur VAL Merits, Helga Merits	COL titel VAL @Nieuw prentenboek met acht gekleurde plaatjes	1
COL titel VAL @Kleine Olle en zijn ekster COL hoofdauteur VAL Kieviet, Cornelis Johannes Kieviet 1858-1931	COL titel VAL @Vakantiepakket COL 2e auteur VAL Stilton, Geronimo Stilton COL 2e auteur VAL Randazzo, Loes Randazzo COL 2e auteur VAL Favia, Leonardo Favia COL 2e auteur VAL Bufi, Ennio Bufi 1976- COL 2e auteur VAL Andolfo, Mirka Andolfo COL 2e auteur VAL Dami, Elisabetta Dami 1958-	1
COL titel VAL De @schoonste dag COL ondertitel VAL gedichten bij gelegenheid der Eerste H. Communie COL editie VAL 2e dr	COL titel VAL De @twee vrienden	1
COL titel VAL De @tranen der acacia's COL hoofdauteur VAL Hermans, Willem Frederik Hermans 1921-1995 COL editie VAL 25e dr	COL titel VAL @Werke der Weltliteratur für die Jugend COL ondertitel VAL Grimmelshausen, Defoe, Cooper, Melville COL 2e auteur VAL Baeumler, Alfred Bäumler 1887-1968	1
COL titel VAL De @appel COL hoofdauteur VAL Bruna, Hendrik Magdalenus Bruna 1927-2017	COL titel VAL De @R in de maand COL ondertitel VAL winterse verhalen COL 2e auteur VAL Waaijer, Petra Waaijer	1
COL titel VAL @Confetti conflict COL hoofdauteur VAL Slee, Carry Slee 1949- COL editie VAL 7e dr COL auteur/primair VAL Slee	COL titel VAL The @Faber book of nursery stories COL 2e auteur VAL Ireson, Barbara Ireson COL 2e auteur VAL Hughes, Shirley Hughes 1929-2022	1
COL titel VAL @Verdriet met mayonaise COL hoofdauteur VAL Slee, Carry Slee 1949- COL editie VAL 12e dr COL auteur/primair VAL Slee	COL titel VAL @Liederenbundel voor Sinterklaas COL vertaling van VAL Liederenbundel voor het Kerstfeest. - [10] p	1
COL titel VAL @Kilometers cola en knetterende ruzie COL hoofdauteur VAL Slee, Carry Slee 1949- COL editie VAL 7e dr COL auteur/primair VAL Slee	COL titel VAL @Grootje's geschiedenis	1
COL titel VAL @Geklutste geheimen met strafwerk toe COL hoofdauteur VAL Slee, Carry Slee 1949- COL editie VAL 6e dr COL auteur/primair VAL Slee	COL titel VAL Een @leerschool voor Robinsons, gevolgd door Van Rotterdam naar Kopenhagen COL hoofdauteur VAL Verne, Jules Gabriel Verne 1828-1905 COL editie VAL [Herdr.] COL vertaling van VAL L'ećole des Robinsons. - 1882	1
COL titel VAL @Op eigen wieken COL ondertitel VAL een verhaal COL hoofdauteur VAL Alcott, Louisa May Alcott 1832-1888 COL 2e auteur VAL Elberts, Gerardina Wilhelmina Elberts 1868-1945 COL 2e auteur VAL Copping, Harold Copping 1863-1932 COL vertaling van VAL Good wives. - 1869	COL titel VAL @STUKBOEK COL 2e auteur VAL _, Abdirahman, Abdirahman	1
COL titel VAL @Nijntje in de sneeuw COL hoofdauteur VAL Bruna, Hendrik Magdalenus Bruna 1927-2017	COL titel VAL @Zwarte handen, witte trommels	1
COL titel VAL @Meester Max en het wiebelkind COL hoofdauteur VAL Kromhout, Rindert Kromhout 1958- COL 2e auteur VAL Weve, Sylvia Weve 1954- COL auteur/primair VAL Kromhout	COL titel VAL @Met St.-Nicolaas naar de WIBA COL 2e auteur VAL Eshuis, Dick Carol Eshuis	1
COL titel VAL @Paul Kruger, de leeuw van Zuid-Afrika COL hoofdauteur VAL Zeeuw, Pieter de Zeeuw J.Gzn. 1890-1968 COL 2e auteur VAL Brandeler, Agnes van den Brandeler-van den Brandeler 1918-2002 COL editie VAL 9e dr	COL titel VAL @Genoveva en andere verhalen	1
COL titel VAL De @zusjes Kriegel COL hoofdauteur VAL Bel, Marc De Bel 1954- COL 2e auteur VAL Bosschaert, Jan Bosschaert 1957- COL editie VAL 7e, herz. dr	COL titel VAL De @onsterfelijke Pa Pinkelman COL hoofdauteur VAL Bomans, Godfried Jan Arnold Bomans 1913-1971 COL 2e auteur VAL Voges, Carol W. Voges 1925-2001 COL editie VAL 8e dr COL Eerder verschenen in VAL De Volkskrant	1
COL titel VAL @Paul Kruger COL ondertitel VAL korte levensschets met platen	COL titel VAL Het @leuke avontuur van Winnie de Poeh COL 2e auteur VAL Milne, Alan Alexander Milne 1882-1956 COL 2e auteur VAL Epes, Miguel Epes	1
COL titel VAL Het @onkruid en de bloem COL ondertitel VAL dagboek van een verslaafd meisje COL 2e auteur VAL Campert, Remco Wouter Campert 1929-2022 COL editie VAL 22e herz. dr COL vertaling van VAL Go ask Alice. - Englewood Cliffs : Prentice-Hall, 1971	COL titel VAL @Beesten aan boord COL hoofdauteur VAL Dahl, Roald Dahl 1916-1990 COL 2e auteur VAL Khing, Thé Tjong-Khing 1933- COL 2e auteur VAL Sparla, Gertrude Theresia Jozefa Maria Sparla 1933- COL 2e auteur VAL Leonard, Frans Leonard COL vertaling van VAL James and the Giant Peach	1
COL titel VAL @Bikkels COL hoofdauteur VAL Slee, Carry Slee 1949- COL 2e auteur VAL Schans, Roelof van der Schans	COL titel VAL @Rawhide Kid. De schurk en de Kid!	1
COL titel VAL @Kara Ben Nemsi COL hoofdauteur VAL May, Karl Friedrich May 1842-1912 COL 2e auteur VAL Ulrich, Josef Ulrich COL 2e auteur VAL Montagne-Andres, Liesbeth Montagne-Andres 1915-1994 COL vertaling van VAL Durch die Wüste. - Oorspr. uitg.: 1892	COL titel VAL Het @biddende kind COL ondertitel VAL gebeden voor de katholieke jeugd	1
COL titel VAL @Walt Disney's Donald Duck vakantieboek COL 2e auteur VAL Disney, Walter Elias Disney 1901-1966 COL editie VAL 1e dr	COL titel VAL De @komedianten COL hoofdauteur VAL Couperus, Louis Marie Anne Couperus 1863-1923 COL editie VAL 2e dr	1
COL titel VAL @Iwan de dwaas, en andere volksvertellingen COL hoofdauteur VAL Tolstoj, L.N. Tolstoj 1828-1910 COL 2e auteur VAL Brandt, Johanna Brandt fl. 1898-1942 COL 2e auteur VAL Hesseling, Dirk Christiaan Hesseling 1859-1941 COL editie VAL 5e dr., 16e-18e duizendtal COL vertaling van VAL →Skazka ob Ivane-durake⇋	COL titel VAL @Tonek z Napoleonovy armády COL hoofdauteur VAL Fabricius, Johan Johannes Fabricius 1899-1981 COL 2e auteur VAL Krijtová, Olga Krijtová 1931-2013 COL 2e auteur VAL Romberg, Michael Romberg COL vertaling van VAL Toontje Poland : een Alkmaarse jongen in de dagen van Napoleon. - Den Haag : Leopold, 1977	1
COL titel VAL @Nagelaten vertellingen COL hoofdauteur VAL Schmid, Johann Christoph Friedrich von Schmid 1768-1854 COL 2e auteur VAL Bos, Gerardus Johannes Bos 1825-1898 COL 2e auteur VAL Trap, Pieter Willem Marinus Trap 1821-1905 COL vertaling van VAL Nachgelassen Erzählungen. - 1856	COL titel VAL @Ali Baba en de veertig roovers COL 2e auteur VAL Broecke, Jaak Floris van den Broecke Sr. 1913-1986	1
COL titel VAL De @bezeten minnaar COL hoofdauteur VAL Rendell, Ruth Rendell 1930-2015 COL 2e auteur VAL Brink-Wessels, N.M. Brink-Wessels COL vertaling van VAL A demon in my view. - London [etc.] : Hutchinson, 1976	COL titel VAL @Turkse volkssprookjes COL 2e auteur VAL Schier, Kurt Schier 1929- COL 2e auteur VAL Kroon, Dirk Kroon 1946- COL vertaling van VAL Türkische Volksmärchen. - Düsseldorf [etc.] : Diederichs, cop. 1967	1
COL titel VAL @Eric Carle's dieren-abc COL hoofdauteur VAL Carle, Eric Carle 1929-2021 COL 2e auteur VAL Westera, Bette Westera 1958- COL auteur/primair VAL Carle	COL titel VAL @Dag, Kikker... dag baby! COL 2e auteur VAL Velthuijs, Max Velthuijs 1923-2005 COL editie VAL Eerste druk	1
COL titel VAL De @gelaarsde kat COL ondertitel VAL eene vertelling van Moeder de Gans	COL titel VAL @Plaatjes en versjes voor onze jeugd	1
COL titel VAL @Rijmsoep COL hoofdauteur VAL Dahl, Roald Dahl 1916-1990 COL 2e auteur VAL Blake, Quentin Saxby Blake 1932- COL 2e auteur VAL Vriesendorp, Gerarde Hubèrte Vriesendorp 1940- COL editie VAL 4e dr COL vertaling van VAL Rhyme stew. - London : Cape, cop. 1989	COL titel VAL Het @meisje met de zwavelstokjes COL hoofdauteur VAL Andersen, Hans Christian Andersen 1805-1875 COL Ook verschenen in een band met 3 andere sprookjes o.d.t. VAL Sprookjes van Andersen in kleuren	1
COL titel VAL Het @meisje dat hield van Tom Gordon COL hoofdauteur VAL King, Stephen Edwin King 1947- COL 2e auteur VAL Gelder, Cherie van Gelder COL vertaling van VAL The girl who loved Tom Gordon. - 1999 COL auteur/primair VAL King	COL titel VAL @Kinderspelen	1
COL titel VAL @Groot vertelboek voor de bijbelse geschiedenis COL hoofdauteur VAL Vries, Anne de Vries 1904-1964 COL 2e auteur VAL Jetses, Cornelis Jetses 1873-1955 COL editie VAL 23e dr COL auteur/primair VAL Vries	COL titel VAL @Teletubbies spelletjes boek	1
COL titel VAL The @posthumous papers of the Pickwick club COL hoofdauteur VAL Dickens, Charles John Huffam Dickens 1812-1870 COL 2e auteur VAL Meynders, P. Meynders	COL titel VAL @Sleuteloog COL hoofdauteur VAL Haasse, Hélène Serafia Haasse 1918-2011	1
COL titel VAL @Hallo, ik ben Dribbel! COL hoofdauteur VAL Hill, Eric Hill 1927-2014 COL vertaling van VAL Spot's noisy walk. - Salspot, cop. 1998	COL titel VAL De @tegenovergestelden	1
COL titel VAL @Klompertje en zijn wijfje COL 2e auteur VAL Bruijn, Margreet Bruijn 1916-2010 COL 2e auteur VAL Michels-Scholten, Johanna Arendina Michels-Scholten 1897- COL 2e auteur VAL Hees-Napjus, Anneke van Hees-Napjus COL editie VAL 2e dr COL vertaling van VAL Van jasjes en broekjes - 1956	COL titel VAL @Aan een zijden draad COL ondertitel VAL zal mijn angst ooit verdwijnen?	1
COL titel VAL @Sambo, ga je mee? COL hoofdauteur VAL Roggeveen, Leonard Roggeveen 1898-1959	COL titel VAL @Walt Disney's Donald Duck 30 jaar COL ondertitel VAL jubileum uitgave COL 2e auteur VAL Disney, Walter Elias Disney 1901-1966	1
COL titel VAL @Prins Willem, Vader des vaderlands COL hoofdauteur VAL Hulst, Willem Gerrit van de Hulst 1879-1963 COL editie VAL 2e dr., 11e-25e duizend COL Later verschenen o.d.t. VAL De prins en de moordenaar	COL titel VAL @Sprookjes van Grimm COL hoofdauteur VAL Grimm, Jacob Ludwig Carl Grimm 1785-1863 COL 2e auteur VAL Grabianski, Janusz Grabianski 1928-1976 COL editie VAL 6e dr	1
COL titel VAL @Onder moeders vleugels COL ondertitel VAL een verhaal COL hoofdauteur VAL Alcott, Louisa May Alcott 1832-1888 COL 2e auteur VAL Elberts, Gerardina Wilhelmina Elberts 1868-1945 COL 2e auteur VAL Vries, Daniël de Vries 1895-1959 COL editie VAL 12e dr. COL vertaling van VAL Little women. - 1868	COL titel VAL @Schoolboek der wetenschappen, ten gebruike van het algemeen en bijzonder voor aenkomende jongelingen ... COL editie VAL 4e druk	1
COL titel VAL De @wereld in! COL hoofdauteur VAL Alcott, Louisa May Alcott 1832-1888 COL 2e auteur VAL Elberts, Gerardina Wilhelmina Elberts 1868-1945 COL 2e auteur VAL Vries, Daniël de Vries 1895-1959 COL editie VAL 8e dr COL vertaling van VAL Jo's boys	COL titel VAL De @zwijgende ruiter	1
COL titel VAL @Waar de Stille Zuidzee roept COL hoofdauteur VAL Konsalik, Heinz G. Konsalik COL 2e auteur VAL Amerongen, Jan van Amerongen 1939-1998 COL editie VAL 2e dr COL vertaling van VAL Das Riff der roten Haie. - Bergisch Gladbach : Lübbe, cop. 1993. - (Bastei Lübbe ; Bd. 12002) COL Vervolg op VAL Het vergeten paradijs	COL titel VAL Het @geheim van de mergelgroeve COL 2e auteur VAL Timmermans, Alphons Joseph August Maria Timmermans 1907-1980 COL 2e auteur VAL Exter, Jan Dirk van Exter 1915-1982 COL editie VAL 5e dr	1
COL titel VAL @Er ligt een appel op een schaal COL hoofdauteur VAL Tellegen, Antonius Otto Hermannus Tellegen 1941- COL auteur/primair VAL Tellegen	COL titel VAL The @Cambridge companion to the classic Russian novel COL 2e auteur VAL Jones, Malcolm Vince Jones COL 2e auteur VAL Miller, Robin Feuer Miller 1947-	1
COL titel VAL @Toch Oranje boven!, of Willem Hendrik, prins van Oranje-Nassau van 1650 tot 1672 COL ondertitel VAL geschiedkundig verhaal voor oud en jong Nederland COL hoofdauteur VAL Louwerse, Pieter Louwerse 1840-1908 COL editie VAL 3e, verb. dr	COL titel VAL De @geschiedenis van het huisje op het ijs	1
COL titel VAL @Op weg naar het einde COL hoofdauteur VAL Reve, Gerard Kornelis van het Reve 1923-2006 COL editie VAL 23 [i.e. 24e] dr	COL titel VAL @Busje Bas doet rare dingen COL 2e auteur VAL Van Cleemput, Gerda Van Cleemput 1935-2022 COL 2e auteur VAL Walschap	1
COL titel VAL @Grimm's Fairy Tales COL hoofdauteur VAL Grimm, Jacob Ludwig Carl Grimm 1785-1863 COL 2e auteur VAL Folkard, Charles Folkard 1878-1963 COL editie VAL [Herdr.]	COL titel VAL @Broertje, toe, speel mee! COL ondertitel VAL acht speelrijmpjes voor de jeugd met gekleurde plaatjes	1
COL titel VAL Het @Halidon complot COL hoofdauteur VAL Ludlum, Robert Ludlum 1927-2001 COL 2e auteur VAL Bruning, Frans J. Bruning COL 2e auteur VAL Haakman, Harry Haakman COL editie VAL 6e dr COL vertaling van VAL The cry of the Halidon. - Rev. ed. - London : HarperCollins, 1996. - Oorspr. uitg. verschenen onder het pseud. Jonathan Ryder: London : Weidenfeld and Nicolson ; New York : Dell, 1974 COL Oorspr. titel VAL Het Halidon komplot : roman van een duivelse samenzwering / Jonathan Ryder. - Utrecht [etc.] : Veen, 1983	COL titel VAL @Tusschen licht en donker COL ondertitel VAL keur van vertellingen, sprookjes, fabels, anekdoten, gedichtjes, spelletjes, kunstjes, rijmen en raadsels COL 2e auteur VAL Ankum, L. van Ankum COL 2e auteur VAL Krabbé, Hendrik Maarten Krabbé 1868-1931 COL 2e auteur VAL Dijk, Tom van Dijk COL editie VAL 5e dr	1
COL titel VAL De @ranch COL hoofdauteur VAL Steel, Danielle Fernande Steel 1947- COL 2e auteur VAL Bruning, Frans J. Bruning COL editie VAL 2e dr COL vertaling van VAL The ranch. - London [etc.] : Bantam Press, 1997	COL titel VAL @Allereerste beginselen der aardrijkskunde, voor de scholen COL 2e auteur VAL Scheerder, H.C. Scheerder	1
COL titel VAL Het @Shepherd commando COL hoofdauteur VAL Ludlum, Robert Ludlum 1927-2001 COL 2e auteur VAL Herlé, Mariët Herlé COL 2e auteur VAL Haakman, Harry Haakman COL editie VAL 16e dr COL vertaling van VAL The road to Gandolfo. - New York : Dial Press, 1975 COL Oorspr. titel onder het pseudoniem Michael Shepherd VAL De dag dat de paus ontvoerd werd. - Wageningen : Veen, 1978	COL titel VAL @Saskia und Tom COL hoofdauteur VAL Haar, Jacob Everard ter Haar 1922-1998 COL 2e auteur VAL Heyst, Ilse van Heyst 1913- COL 2e auteur VAL Moßmann, Barbara Mossmann COL vertaling van VAL Saskia en Jeroen, domme dingen. - Amsterdam : Van Holkema & Warendorf, [1956]	1
COL titel VAL @Ongeluk COL hoofdauteur VAL Steel, Danielle Fernande Steel 1947- COL 2e auteur VAL Lakens Douwes, Marianne Lakens Douwes COL editie VAL 2e dr COL vertaling van VAL Accident. - New York : Delacorte Press, cop. 1994	COL titel VAL @Annejet laat het er niet bij zitten COL ondertitel VAL met zwarte ills. van Herson COL hoofdauteur VAL Diekmann, Maria Hendrika Jozina Diekmann 1925-2017 COL 2e auteur VAL Herson, Herson COL editie VAL [herdr.]	1
COL titel VAL @Prijs der liefde COL hoofdauteur VAL Steel, Danielle Fernande Steel 1947- COL 2e auteur VAL Bakker, Margot Bakker COL editie VAL 2e dr COL vertaling van VAL Fine things. - New York : Delacorte Press, 1987	COL titel VAL @Vijftig Nederlandse sprookjes COL 2e auteur VAL Sinninghe, Jacques Rudolf Willem Sinninghe 1904-1988 COL 2e auteur VAL Vries, Jan Pieter Marie Laurens de Vries 1890-1964	1
COL titel VAL @Desperation COL hoofdauteur VAL King, Stephen Edwin King 1947- COL 2e auteur VAL Vernooy, Robert Vernooy 1961- COL editie VAL 6e dr COL vertaling van VAL Desperation. - London : Hodder & Stoughton, 1996	COL titel VAL @Bijbel voor jonge mensen COL 2e auteur VAL Bettschart, Oscar Bettschart COL 2e auteur VAL Schaeck, M.I. van Schaeck COL editie VAL 4e dr COL vertaling van VAL Die Geschichte unseres Heiles. - Einsiedeln : Benziger	1
COL titel VAL @Casa Cara COL hoofdauteur VAL Saris, Helena Barbara Wilhelmina Saris 1915-1999	COL titel VAL @Ali Baba en de veertig rovers en Aladdin en de wonderlamp COL 2e auteur VAL Gerhard, Jan Willem Gerhard 1864-1923 COL 2e auteur VAL Fell, Herbert Granville Fell 1872-1951 COL editie VAL 3e dr	1
COL titel VAL @Iets van waarde COL hoofdauteur VAL Peters, Karin Peters COL auteur/primair VAL Peters	COL titel VAL @Beertje Bruin krijgt een pak	1
COL titel VAL @Op eigen wieken COL ondertitel VAL een verhaal COL hoofdauteur VAL Alcott, Louisa May Alcott 1832-1888 COL 2e auteur VAL Elberts, Gerardina Wilhelmina Elberts 1868-1945 COL 2e auteur VAL Vries, Daniël de Vries 1895-1959 COL editie VAL 11e dr COL vertaling van VAL Good wives. - 1869	COL titel VAL @Verhalen omnibus COL ondertitel VAL 53 verhalen uit de wereldliteratuur	1
COL titel VAL @Jack and the beanstalk	COL titel VAL @Normalliniatur für Schrift und Ziffern COL ondertitel VAL ihre physiologische Bestimmung und methodische Anwendung; Ergänzung zum Lehrbuche für den Schreibunterricht COL 2e auteur VAL Händler, R. Händler	1
COL titel VAL @Buitenspel COL hoofdauteur VAL Hollander, Vivian den Hollander 1953- COL 2e auteur VAL Straaten, Harmen van Straaten 1961- COL auteur/primair VAL Hollander	COL titel VAL @Hans en Grietje	1
COL titel VAL @Old mother Hubbard	COL titel VAL Le @livre des petits enfants; abécédaire simple et facile, où les difficultés de la lecture sont graduées de manier à les rendre moins sensibles; orné de figures qui aident à l'enfant à mieux reconnaître les sons que forment les lettres unies par syllabes et par mots; et terminé par des leçons de lecture latine	1
COL titel VAL @Buiten! COL ondertitel VAL een boek voor onze kinderen	COL titel VAL @Wald der Erwartung COL ondertitel VAL das Leben des Charles von Orléans COL ondertitel VAL Roman COL hoofdauteur VAL Haasse, Hélène Serafia Haasse 1918-2011 COL 2e auteur VAL Csollány, Maria Csollány 1932- COL vertaling van VAL Het woud der verwachting : het leven van Charles van Orléans : roman. - Amsterdam : Querido, 1949	1
COL titel VAL @Scheepsmaat Woeltje COL hoofdauteur VAL Norel, Klaas Norel 1899-1971 COL 2e auteur VAL Hoogendoorn, Gerardus Dominicus Hoogendoorn 1892-1948 COL editie VAL 2e dr COL Wordt vervolgd door VAL Stuurman Aart	COL titel VAL De @gebroeders Leeuwenhart COL hoofdauteur VAL Lindgren, Astrid Anna Emilia Lindgren 1907-2002 COL 2e auteur VAL Törnqvist-Verschuur, Marguérite Elisabeth Verschuur 1935- COL 2e auteur VAL Wikland, Ilon Wikland 1930- COL vertaling van VAL Bröderna Lejonhjärta. - Stockholm : Rabén & Sjögren, 1973	1
COL titel VAL @Fien en Pien COL hoofdauteur VAL Bruna, Hendrik Magdalenus Bruna 1927-2017	COL titel VAL @Lover of loser COL hoofdauteur VAL Slee, Carry Slee 1949-	1
COL titel VAL Het @grote vertelselboek COL 2e auteur VAL Boer-van Strien, C.J. de Boer-van Strien 1895-1975 COL 2e auteur VAL Donker, Petronella Donker 1914-1993	COL titel VAL De @kinderen van den zoetelaar, of Nederland gedurende de eerste regeeringsjaren van prins Willem III COL hoofdauteur VAL Andriessen, Pieter Jacob Andriessen 1815-1877 COL editie VAL 4e dr	1
COL titel VAL Een @speciaal geval COL hoofdauteur VAL Steel, Danielle Fernande Steel 1947- COL 2e auteur VAL Benink, Carla Benink COL vertaling van VAL Special delivery.  - London [etc.] : Bantam Press, 1997 COL auteur/primair VAL Steel	COL titel VAL @Lam COL 2e auteur VAL Groen, Leendert Nicolaas van Groen 1919-	1
COL titel VAL @Geluk gloort aan de horizon COL hoofdauteur VAL Cookson, Catherine Anne Cookson 1906-1998 COL 2e auteur VAL Berghand, Arjen Berghand COL editie VAL 3e dr COL vertaling van VAL Hannah Massey. - London : MacDonald, 1964 COL Oorspr. Nederlandse titel VAL De slang en Eva. - Utrecht : De Lanteern, 1966	COL titel VAL @Kleurboek	1
COL titel VAL @Liefde in Siberië COL hoofdauteur VAL Konsalik, Heinz G. Konsalik COL 2e auteur VAL Vorrink, J.W. Vorrink COL editie VAL 3e dr COL vertaling van VAL Transsiberien-Express. - Bayreuth : Hestia, 1974	COL titel VAL La @biblia contada a los niños COL hoofdauteur VAL Vries, Anne de Vries 1904-1964 COL 2e auteur VAL Zahonero Vivó, José Zahonero Vivó COL 2e auteur VAL Schäfer, Hermine F. Schäfer COL editie VAL 3a ed COL vertaling van VAL Kleutervertelboek voor de bijbelse geschiedenis. - Kampen : Kok, 1948	1
COL titel VAL @Sinterklaas COL ondertitel VAL het verhaal van Sinterklaas die zijn muts verloren had COL hoofdauteur VAL Hulst, Willem Gerrit van de Hulst 1879-1963 COL 2e auteur VAL Hulst, Willem Gerrit van de Hulst 1917-2006 COL editie VAL 5e dr COL 1e dr. verschenen o.d.t. VAL Het verhaal van Sinterklaas die zijn muts verloren had. - 1967	COL titel VAL @Aan myn hartedief	1
COL titel VAL Het @karretje COL hoofdauteur VAL Hulst, Willem Gerrit van de Hulst 1879-1963 COL 2e auteur VAL Hulst, Willem Gerrit van de Hulst 1917-2006 COL editie VAL 4e dr	COL titel VAL @Maandewark COL ondertitel VAL Drèentse verhaolen en gedichten COL 2e auteur VAL Kleine, Klaas Kleine 1940-2000	1
COL titel VAL Het @nieuwe voorleesboek COL ondertitel VAL moedervertellingen COL hoofdauteur VAL Hulst, Willem Gerrit van de Hulst 1879-1963 COL 2e auteur VAL Hulst, Willem Gerrit van de Hulst 1917-2006 COL editie VAL 3e dr	COL titel VAL @Zwart COL ondertitel VAL Afro-Europese literatuur uit de Lage Landen COL 2e auteur VAL Sherif, Vamba Omar Sherif 1973- COL editie VAL Tweede druk	1
COL titel VAL De @valstrik COL hoofdauteur VAL Rendell, Ruth Rendell 1930-2015 COL 2e auteur VAL Houtsma, Sanderijn Dora Houtsma-van Schaik 1922-2012 COL vertaling van VAL The face of trespass. - 1974	COL titel VAL De @kleine diacones COL 2e auteur VAL Rünckel COL 2e auteur VAL Veka COL editie VAL 2e dr	1
COL titel VAL @Erik, of Het kleine insectenboek COL hoofdauteur VAL Bomans, Godfried Jan Arnold Bomans 1913-1971 COL 2e auteur VAL Thole, Carolus Adrianus Maria Thole 1914-2000 COL editie VAL Twee en twintigste druk	COL titel VAL @Walt Disney's Sneeuwwitje en de 7 dwergen COL hoofdauteur VAL Disney, Walter Elias Disney 1901-1966	1
COL titel VAL @Mannen van Sliedrecht COL ondertitel VAL roman COL hoofdauteur VAL Norel, Klaas Norel 1899-1971	COL titel VAL @Neuer Bildersaal	1
COL titel VAL @Frog is a hero COL hoofdauteur VAL Velthuijs, Max Velthuijs 1923-2005 COL vertaling van VAL Kikker is een held. - Amsterdam : Leopold, cop. 1995	COL titel VAL @Gerda vertelt en tekent	1
COL titel VAL @Carrie COL hoofdauteur VAL King, Stephen Edwin King 1947- COL 2e auteur VAL Nijkerk, F.I. Nijkerk-Pieters COL 2e auteur VAL Nijhuis, Marian Nijhuis COL editie VAL 13e, herz. dr COL vertaling van VAL Carrie. - Garden City, N.Y. : Doubleday, 1974	COL titel VAL Het @Hoover archief COL ondertitel VAL roman van een misleidende intrige COL hoofdauteur VAL Ludlum, Robert Ludlum 1927-2001 COL 2e auteur VAL Hattum, J. van Hattum COL editie VAL 5e dr COL vertaling van VAL The Chancellor manuscript. - 1977	1
COL titel VAL @Verhaaltjes uit het toverbos COL 2e auteur VAL Schermeleé, Wilhelmina Schermelé 1904-1995	COL titel VAL Het @mysterie van Sittaford COL hoofdauteur VAL Christie, Agatha Christie 1890-1976 COL 2e auteur VAL Vuerhard-Berkhout, Anna Elisabeth Catharina Vuerhard-Berkhout 1885- COL vertaling van VAL The Sittaford mystery. - Londen : Collins, 1931	1
COL titel VAL Een @vreemde vrouw COL hoofdauteur VAL Rendell, Ruth Rendell 1930-2015 COL 2e auteur VAL Andriessen, J.E.A. Andriessen-van de Zande COL editie VAL 2e dr COL vertaling van VAL Shake hands for ever. - London : Hutchinson, 1975	COL titel VAL Een @kerstverhaal COL hoofdauteur VAL Dickens, Charles John Huffam Dickens 1812-1870 COL 2e auteur VAL Wit COL vertaling van VAL A Christmas carol in prose, 1843	1
COL titel VAL @Eline Vere COL hoofdauteur VAL Couperus, Louis Marie Anne Couperus 1863-1923	COL titel VAL @Jan de wasscher	1
COL titel VAL @Kerstverhalen COL 2e auteur VAL Polders, Loek Polders COL editie VAL 1e dr	COL titel VAL @Pinocchio	1
COL titel VAL @In blind vertrouwen COL hoofdauteur VAL Konsalik, Heinz G. Konsalik COL 2e auteur VAL Rijsbergen, Miep Rijsbergen COL vertaling van VAL Eine Sünde zuviel. - Bayreuth : Hestia, 1965	COL titel VAL @Lieve dieren	1
COL titel VAL @Voor zomer en winter COL ondertitel VAL vertellingen COL 2e auteur VAL Cramer-Schaap, Dina Alida Cramer-Schaap 1893-1976 COL 2e auteur VAL Cramer, Marie Cramer 1887-1977	COL titel VAL El @inspector COL hoofdauteur VAL Hartog, Johannes de Hartog 1914-2002 COL 2e auteur VAL Elias, Francisco Elías de Tejada COL vertaling van VAL The inspector. - New York : Atheneum publishers, 1960	1
COL titel VAL @Winterpret COL ondertitel VAL een nieuw prentenboek	COL titel VAL @Ratje, een jongen van de straat COL hoofdauteur VAL Vries, Anne de Vries 1904-1964 COL 2e auteur VAL Bottema, Tjeerd Bottema 1884-1978 COL editie VAL 37e dr	1
COL titel VAL @Animal friends	COL titel VAL De @ondeugende streken van Minet COL 2e auteur VAL Tonelli, E. Tonelli	1
COL titel VAL @Animal friends COL ondertitel VAL picture book COL 2e auteur VAL Trimmer	COL titel VAL @Herfst COL hoofdauteur VAL Cramer, Marie Cramer 1887-1977	1
COL titel VAL @Grootmoeders rijmpjes en versjes COL 2e auteur VAL Lever, Jan Lever COL editie VAL 2e dr	COL titel VAL @Mijn vertelselboek COL ondertitel VAL keur van nieuwe, oorspronkelijke vertellingen van de beste auteurs COL 2e auteur VAL Woude, Johanna van Woude COL 2e auteur VAL Witkamp, E.S. Witkamp COL editie VAL 2e dr	1
COL titel VAL @Blinker und das bioskopische Lastenfahrrad COL ondertitel VAL Abenteuer-Roman COL hoofdauteur VAL Bel, Marc De Bel 1954- COL 2e auteur VAL Schmidt, Silke Schmidt COL vertaling van VAL Blinker en de bakfietsbioscoop. - Leuven ; Den Haag : Infodok, 1989	COL titel VAL @Chuyện Ông Gióng COL 2e auteur VAL Tô Hoài, Tô Hoài COL 2e auteur VAL Mai Long, Mai Long COL editie VAL 3e dr	1
COL titel VAL @Goedemorgen, welterusten COL ondertitel VAL gedichten voor kinderen en andere volwassenen COL 2e auteur VAL Fens, Cornelis Walterus Antonius Fens 1929-2008 COL 2e auteur VAL Roelofsz, Joost Roelofsz 1948- COL 2e auteur VAL Berserik, Hermanus Berserik 1921-2002 COL editie VAL 4e dr	COL titel VAL @Dierenliedjes en -versjes COL 2e auteur VAL Wilkes, Angela Wilkes COL 2e auteur VAL Burton, Jane Burton 1933- COL 2e auteur VAL Lemmers, A.C.A. Lemmers COL vertaling van VAL Animal nursery rhymes. - London : Dorling Kindersley, cop. 1992	1
COL titel VAL Der @Vampirklub COL hoofdauteur VAL Loon, Paulus Stephanus Elisabeth Lambertus Maria van Loon 1955- COL 2e auteur VAL Look, Hugo Van Look 1960- COL 2e auteur VAL Löcker, Daniel Löcker COL editie VAL 1. Aufl COL vertaling van VAL De vampierclub. - Tilburg : Zwijsen, cop. 1994. - (Salto)	COL titel VAL @Joris en de geheimzinnige toverdrank COL hoofdauteur VAL Dahl, Roald Dahl 1916-1990 COL 2e auteur VAL Blake, Quentin Saxby Blake 1932- COL 2e auteur VAL Vriesendorp, Gerarde Hubèrte Vriesendorp 1940- COL vertaling van VAL George's marvellous medicine. - London : Jonathan Cape, 1981	1
COL titel VAL @Wer hat schon Angst vor Vampiren! COL hoofdauteur VAL Loon, Paulus Stephanus Elisabeth Lambertus Maria van Loon 1955- COL 2e auteur VAL Löcker, Daniel Löcker COL 2e auteur VAL Look, Hugo Van Look 1960- COL editie VAL 1. Aufl COL vertaling van VAL Bang voor vampiers? - Tilburg : Zwijsen, cop. 1992. - (Salto)	COL titel VAL @Juliana COL ondertitel VAL een biografie in foto's van de koningin der Nederlanden COL 2e auteur VAL Schaafsma, Henk Schaafsma 1924-1988	1
COL titel VAL @Wonderbaarlijke en zeldzame historie van Thyl Ulenspiegel, van zijn schalke, listige potzen en boeveryen, die hy zo in zijn leven als ook in zijn dood bedreven heeft COL ondertitel VAL zeer tydkortig en geneuglyk om te lezen COL ondertitel VAL voor oude en jonge lieden	COL titel VAL @Damwerkboek "tientjes" COL 2e auteur VAL Rooij, Leendert de Rooij 1941-	1
COL titel VAL De @vermakelijke lotgevallen van Uilenspiegel COL ondertitel VAL op nieuw aan 't volk verteld	COL titel VAL @Dit is Nijntje COL hoofdauteur VAL Bruna, Hendrik Magdalenus Bruna 1927-2017	1
COL titel VAL @Markies Kattenpies COL hoofdauteur VAL Slee, Carry Slee 1949- COL 2e auteur VAL Straaten, Harmen van Straaten 1961-	COL titel VAL @Dongeng oetjing diistiwĕl COL 2e auteur VAL Perrault, Charles Perrault 1628-1703	1
COL titel VAL @Dochters van Afrika COL ondertitel VAL verhalen over vrouwenlevens COL 2e auteur VAL Scheepers, Riana Scheepers 1957- COL 2e auteur VAL Jong-Goossens, Riet de Jong-Goossens 1937- COL editie VAL 2e dr COL vertaling van VAL Dogters van Afrika : verhale oor Suid-Afrikaanse vroue. - Kaapstad : Tafelberg, cop. 1997	COL titel VAL @Patrons pour poupée de la grandeur de 21 centm.	1
COL titel VAL @Advocaten van de duivel COL ondertitel VAL elf legal thriller-verhalen COL 2e auteur VAL Bernhardt, William Bernhardt 1960- COL 2e auteur VAL Wit, J.J. de Wit COL editie VAL 3e dr COL vertaling van VAL Legal briefs : stories by today's best legal thriller writers. - London : Headline Feature, 1998	COL titel VAL @Onschatbare klassieker COL ondertitel VAL jaarboek 26-2016 COL ondertitel VAL 10000 klassiekers, 1500 youngtimers COL 2e auteur VAL Haakman, Jan Haakman COL 2e auteur VAL Boer, Jan de Boer	1
COL titel VAL @Lieve mama COL hoofdauteur VAL Van Genechten, Guido Van Genechten 1957-	COL titel VAL @Miffy at the gallery COL hoofdauteur VAL Bruna, Hendrik Magdalenus Bruna 1927-2017 COL 2e auteur VAL Crampton, Patricia Crampton COL vertaling van VAL Nijntje in het museum. - Amsterdam : Mercis, 1997	1
COL titel VAL @Woordjes leren	COL titel VAL @Kinderen bemint uwe ouders COL editie VAL Derde druk	1
COL titel VAL @Baby's eerste woordjes COL 2e auteur VAL Leijden, René van Leijden	COL titel VAL Een @aanslag op den president	1
COL titel VAL @Drummer Hoff COL 2e auteur VAL Emberley, Barbara Anne Emberley 1932- COL 2e auteur VAL Emberley, Edward R. Emberley 1931- COL editie VAL 2nd pr	COL titel VAL @Van den dood gered	1
COL titel VAL De @kinderen van het Kastanjehuis COL hoofdauteur VAL Graaf, Anke de Graaf 1927-2019 COL Vervolg op VAL Ingrids gezin	COL titel VAL Een @valsche vriend	1
COL titel VAL @Waarom mijn moeder COL hoofdauteur VAL Thijssing-Boer, Henny Thijssing-Boer 1933-2011 COL Vervolg op VAL Een stoffelijk bewijs	COL titel VAL @Walt Disney's De Aristocats COL hoofdauteur VAL Disney, Walter Elias Disney 1901-1966	1
COL titel VAL @Op de Kermis COL ondertitel VAL Ziet! O ziet eens, lieve jeugd! Allerhande vreemde zaken! Eens toch is er kermis vreugd, En dan mag men zich vermaken!	COL titel VAL @Kleine helden COL ondertitel VAL 9 beeldverhalen over mensen die nooit de krantenkoppen halen	1
COL titel VAL @Lente, zomer, herfst, winter	COL titel VAL @Lente nocturne COL hoofdauteur VAL Saris, Helena Barbara Wilhelmina Saris 1915-1999 COL 2e auteur VAL Herson, Herson	1
COL titel VAL @Reintje van der Schalk, markies van Eijerstruiven, grootmeester van het kippenhok, en vrijheer van de druiven COL editie VAL 6de, verb. dr	COL titel VAL De @gebroken melodie COL hoofdauteur VAL Saris, Helena Barbara Wilhelmina Saris 1915-1999 COL auteur/primair VAL Saris	1
COL titel VAL @Gesloten schakels COL hoofdauteur VAL Saris, Helena Barbara Wilhelmina Saris 1915-1999	COL titel VAL @Goeiemorgen, Muis COL hoofdauteur VAL Cousins, Elizabeth Cousins 1964- COL 2e auteur VAL Brenner, Andrew Brenner COL editie VAL 2e dr COL vertaling van VAL Good morning, Maisy. - London : Walker Books, cop. 2001	1
COL titel VAL Het @stille volk COL hoofdauteur VAL Saris, Helena Barbara Wilhelmina Saris 1915-1999	COL titel VAL @Vaderlandsche liederen	1
COL titel VAL @Op weg naar toen COL hoofdauteur VAL Saris, Helena Barbara Wilhelmina Saris 1915-1999	COL titel VAL @Vermakelijke lectuur voor kinderen, of Iets van alles COL ondertitel VAL bestaande in leerzame vertellingen, zamenspraken, lessen en spreuken, brieven, fabelen, gedichtjes en raadsels, een kamer-tooneelspel COL ondertitel VAL alle geschikt tot nuttige en aangename uitspanningen	1
COL titel VAL De @bonte tuin COL hoofdauteur VAL Saris, Helena Barbara Wilhelmina Saris 1915-1999	COL titel VAL @Hollands glorie COL ondertitel VAL roman van de zeesleepvaart COL hoofdauteur VAL Hartog, Johannes de Hartog 1914-2002 COL editie VAL 24e dr	1
COL titel VAL @Herinnering aan Tjula COL hoofdauteur VAL Saris, Helena Barbara Wilhelmina Saris 1915-1999	COL titel VAL @Voorrijden, mevrouw? COL ondertitel VAL een schelmenroman COL hoofdauteur VAL Fabricius, Johan Johannes Fabricius 1899-1981	1
COL titel VAL @Letters in de lucht COL hoofdauteur VAL Saris, Helena Barbara Wilhelmina Saris 1915-1999	COL titel VAL De @man die de treinen voorbij zag gaan COL hoofdauteur VAL Simenon, Georges Joseph Christian Simenon 1903-1989 COL 2e auteur VAL Castro, Marijke de Castro COL vertaling van VAL L'homme regardait passer les trains. - Paris : Gallimard, 1938	1
COL titel VAL De @gouden handjes COL hoofdauteur VAL Saris, Helena Barbara Wilhelmina Saris 1915-1999	COL titel VAL @Wat is de waarheid COL hoofdauteur VAL Graaf, Anke de Graaf 1927-2019	1
COL titel VAL @Bloemen voor Bettina COL hoofdauteur VAL Saris, Helena Barbara Wilhelmina Saris 1915-1999	COL titel VAL @12 sprookjes en rijmpjes COL 2e auteur VAL Bodenheim, Johanna Cornelia Hermanna Bodenheim 1874-1951	1
COL titel VAL De @gouden stem COL hoofdauteur VAL Saris, Helena Barbara Wilhelmina Saris 1915-1999 COL 2e auteur VAL Anjou, Louise d' Anjou COL editie VAL 1e dr COL auteur/primair VAL Saris	COL titel VAL @Unsere Bücher	1
COL titel VAL @Eva COL hoofdauteur VAL Andriessen, Pieter Jacob Andriessen 1815-1877 COL 2e auteur VAL Bos, Gerardus Johannes Bos 1825-1898 COL editie VAL 2e dr	COL titel VAL @Op de keper beschouwd COL hoofdauteur VAL Bomans, Godfried Jan Arnold Bomans 1913-1971 COL editie VAL 2e dr COL Grotendeels eerder verschenen in VAL De Volkskrant	1
COL titel VAL @Onder de hete Caraïbische zon COL hoofdauteur VAL Fabricius, Johan Johannes Fabricius 1899-1981	COL titel VAL @Dora en de luchtballon	1
COL titel VAL The @Death and Burial of Cock Robin	COL titel VAL @Laatste kans in Sarajevo COL hoofdauteur VAL Konsalik, Heinz G. Konsalik COL 2e auteur VAL Bouman, Cor Bouman COL vertaling van VAL Schiff der Hoffnung. - Bayreuth : Hestia Verlag, ©1968	1
COL titel VAL Een @kerstvertelling COL ondertitel VAL (een kerstzang in proza) COL hoofdauteur VAL Dickens, Charles John Huffam Dickens 1812-1870 COL 2e auteur VAL Hoog, Else Hoog 1937- COL editie VAL 2e dr COL vertaling van VAL A Christmas carol. - 1843 COL auteur/primair VAL Dickens	COL titel VAL @Toontje Poland COL ondertitel VAL een Alkmaarse jongen in Napoleons dagen COL hoofdauteur VAL Fabricius, Johan Johannes Fabricius 1899-1981 COL 2e auteur VAL Wilde, Dirk de Wilde 1905-1994 COL editie VAL 2e dr COL Vervolgd door VAL Toontje Poland onder de tropenzon	1
COL titel VAL Het @jaar rond COL ondertitel VAL verhalen voor ieder jaargetijde COL 2e auteur VAL Hermsen-Janssen, Josée Hermsen COL Herz. versie van VAL Super groot lees- en speelboek voor het hele jaar. - Chevron : Hemma, 1996	COL titel VAL @Kreeft COL ondertitel VAL 22 juni-22 juli COL hoofdauteur VAL Oud, Pauline Oud 1963-	1
COL titel VAL @In Londen en Parijs COL hoofdauteur VAL Dickens, Charles John Huffam Dickens 1812-1870 COL 2e auteur VAL Lindo, Mark Prager Lindo 1819-1877 COL 2e auteur VAL Barnard, J. Barnard COL editie VAL Geïllustreerde uitgaaf COL vertaling van VAL A tale of two cities. - 1859	COL titel VAL The @tale of Pigling Bland COL hoofdauteur VAL Potter, Helen Beatrix Potter 1866-1943	1
COL titel VAL @Little men COL ondertitel VAL life at Plumfield with Jo's boys COL hoofdauteur VAL Alcott, Louisa May Alcott 1832-1888 COL editie VAL authorized edition	COL titel VAL @Geschiedenis COL 2e auteur VAL Vijver, Mike van der Vijver COL 2e auteur VAL Mensing, Hanny Mensing COL 2e auteur VAL Crawford, Andy Crawford COL 2e auteur VAL Hutchins, Ray Hutchins	1
COL titel VAL @Kindergeluk COL 2e auteur VAL EAC, EAC	COL titel VAL @Mestreechter keersverhaole COL 2e auteur VAL Essers, H.A. Essers 1926-1995 COL editie VAL 2en dr., oetgebreid	1
COL titel VAL De @schelmse streken en snakerijen van Tijl Uilenspiegel COL hoofdauteur VAL Hildebrand, Annettes Dideric Hildebrand 1907-1977 COL 2e auteur VAL Lutz, Johannes Hermanus Lutz 1888-1957 COL editie VAL [Herdruk]	COL titel VAL @Walt Disney's Donald Duck groot winterboek COL 2e auteur VAL Disney, Walter Elias Disney 1901-1966	1
COL titel VAL @Sans famille COL hoofdauteur VAL Malot, Hector Henri Malot 1830-1907	COL titel VAL @Brug tussen gisteren en morgen COL hoofdauteur VAL Saris, Helena Barbara Wilhelmina Saris 1915-1999 COL 2e auteur VAL Borrebach, Henri Carl Johan Elisa Borrebach 1903-1991	1
COL titel VAL @Groot Sinterklaas speelboek COL ondertitel VAL een boek vol met spelletjes-tekenvoorbeelden, kleurplaten-puzzels-verhaaltjes en de bekende versjes-etc. over en voor Sinterklaas	COL titel VAL @Jezus, ik be-min u COL ondertitel VAL ge-be-den-boek voor de ka-tho-lie-ke jeugd	1
COL titel VAL De @Takkenbossen winnen een olifant COL hoofdauteur VAL Busser, Marianne Busser 1958-2025 COL 2e auteur VAL Steen, Wilhelmus Gijsbertus Henricus Maria van der Steen 1966-	COL titel VAL @Zeven kerstvertellingen COL hoofdauteur VAL Hulst, Willem Gerrit van de Hulst 1879-1963 COL 2e auteur VAL Dubbelman, Maarten Dubbelman 1916- COL editie VAL 4e dr	1
COL titel VAL @Keet in de klas COL 2e auteur VAL Andreus, Hans Andreus 1926-1977 COL 2e auteur VAL Gerritsen, Paula Gerritsen 1956-	COL titel VAL De @portefeuille met platen, of Grootvader Sprankhof en zijne kleinkinderen COL 2e auteur VAL Koetsveld, Cornelis Eliza van Koetsveld 1807-1893	1
COL titel VAL @Kleuters zingen en spelen COL ondertitel VAL liedjes en spelletjes COL 2e auteur VAL Groothoff, Ans C. Groothoff COL 2e auteur VAL IJzerman, Hermina Woutera IJzerman-van Bemmelen 1902-1985 COL 2e auteur VAL Verrijn Stuart, Sophie E. Verrijn Stuart 1890-1946 COL 2e auteur VAL Michielsen, Alie Michielsen COL 2e auteur VAL Veeken-Bakker, Johanna Wynanda Veeken-Bakker COL 2e auteur VAL Soetekouw, J.P. Soetekouw	COL titel VAL Het @geheim van het donkere bos COL 2e auteur VAL Kromhout, Rindert Kromhout 1958- COL 2e auteur VAL Halfmouw, Saskia Halfmouw 1968- COL editie VAL 1e dr	1
COL titel VAL @Hollands glorie COL hoofdauteur VAL Hartog, Johannes de Hartog 1914-2002 COL editie VAL 32e dr	COL titel VAL @Azuba, de dochter van den ouden jood COL ondertitel VAL een vertelling uit den tijd van het veemgericht COL hoofdauteur VAL Zeeuw, Pieter de Zeeuw J.Gzn. 1890-1968	1
COL titel VAL @Kern der Godlyke waarheden voor de jeugd	COL titel VAL De @Spookruiter. Tarantula de afperser	1
COL titel VAL @Nijntje en Nina COL hoofdauteur VAL Bruna, Hendrik Magdalenus Bruna 1927-2017 COL editie VAL 1st ed COL auteur/primair VAL Bruna	COL titel VAL @Anneke en de sik COL hoofdauteur VAL Hulst, Willem Gerrit van de Hulst 1879-1963 COL 2e auteur VAL Hulst, Willem Gerrit van de Hulst 1917-2006 COL editie VAL 10e dr	1
COL titel VAL @Pim en Wim COL hoofdauteur VAL Bruna, Hendrik Magdalenus Bruna 1927-2017 COL editie VAL 1st ed COL auteur/primair VAL Bruna	COL titel VAL @Bange Maks COL 2e auteur VAL Stoffers, Rie Stoffers	1
COL titel VAL @Boris en de paraplu COL hoofdauteur VAL Bruna, Hendrik Magdalenus Bruna 1927-2017 COL editie VAL 1st ed COL auteur/primair VAL Bruna	COL titel VAL Het @tweede boek van Dik Trom COL hoofdauteur VAL Kieviet, Cornelis Johannes Kieviet 1858-1931 COL 2e auteur VAL Braakensiek, Johan Coenraad Braakensiek 1858-1940 COL editie VAL 35e dr	1
COL titel VAL De @buik van meneer Hobbema COL hoofdauteur VAL Busser, Marianne Busser 1958-2025 COL 2e auteur VAL Wolf, Alex de Wolf 1958-	COL titel VAL @Heksje Mimi viert Kerstmis COL hoofdauteur VAL Amant, Kathleen Amant 1969- COL editie VAL Tweede druk	1
COL titel VAL De @koning zonder kroon COL hoofdauteur VAL Busser, Marianne Busser 1958-2025 COL 2e auteur VAL Steen, Wilhelmus Gijsbertus Henricus Maria van der Steen 1966-	COL titel VAL @Oude en nieuwe zeden COL ondertitel VAL een verhaal voor meisjes COL hoofdauteur VAL Alcott, Louisa May Alcott 1832-1888 COL 2e auteur VAL Davina, Davina	1
COL titel VAL De @sprookjesschatkist COL 2e auteur VAL Martin, Annie-Claude Martin COL vertaling van VAL Grand contes merveilleux. - Paris : Nathan, 1990	COL titel VAL Het @prentensprookje van Tonny de pony	1
COL titel VAL @Assepoester COL 2e auteur VAL Kuhn, Felicitas Kuhn 1926-	COL titel VAL @I see a song COL hoofdauteur VAL Carle, Eric Carle 1929-2021	1
COL titel VAL De @knorreborreboerderij COL hoofdauteur VAL Slee, Carry Slee 1949- COL auteur/primair VAL Slee	COL titel VAL @Wolfje en de boze jongens COL hoofdauteur VAL Disney, Walter Elias Disney 1901-1966	1
COL titel VAL @Dikkie Dik COL ondertitel VAL het geblokte blokboekje COL hoofdauteur VAL Boeke, Henriëtte Boeke 1948- COL 2e auteur VAL Norden, Arthur van Norden 1947- COL editie VAL 1e dr	COL titel VAL @Peerke en z'n kameraden COL hoofdauteur VAL Hulst, Willem Gerrit van de Hulst 1879-1963 COL 2e auteur VAL Hulst, Willem Gerrit van de Hulst 1917-2006 COL editie VAL 22e dr	1
COL titel VAL @Dikkie Dik COL ondertitel VAL het witte blokboekje COL hoofdauteur VAL Boeke, Henriëtte Boeke 1948- COL 2e auteur VAL Norden, Arthur van Norden 1947- COL editie VAL 1e dr	COL titel VAL @Voorrijden, mevrouw? COL ondertitel VAL Een schelmenroman COL hoofdauteur VAL Fabricius, Johan Johannes Fabricius 1899-1981	1
COL titel VAL @Waar de palmen ruisen COL hoofdauteur VAL Konsalik, Heinz G. Konsalik COL 2e auteur VAL Rijsbergen, Miep Rijsbergen COL vertaling van VAL Das Mädchen und der Zauberer. - München : Breitbrunn, cop. 1984	COL titel VAL @Kiekeboe COL ondertitel VAL ik leer nieuwe woorden COL ondertitel VAL wat zit er achter het flapje?	1
COL titel VAL @Als het hart hunkert COL hoofdauteur VAL Cookson, Catherine Anne Cookson 1906-1998 COL 2e auteur VAL Havander, Emma Havander COL vertaling van VAL The unbaited trap. - London : MacDonald, 1966	COL titel VAL @Leuke waggelkopdieren COL 2e auteur VAL Eshuis, Dick Carol Eshuis	1
COL titel VAL @Transit COL ondertitel VAL Roman COL hoofdauteur VAL Haasse, Hélène Serafia Haasse 1918-2011 COL 2e auteur VAL Baryga, Heike Baryga 1966- COL editie VAL 1. Aufl COL vertaling van VAL Transit. - Amsterdam : CPNB, cop. 1994. - Uitg. ter gelegenheid van de Boekenweek 1994	COL titel VAL @Verzen van verzet COL hoofdauteur VAL Cramer, Marie Cramer 1887-1977	1
COL titel VAL @Parcival COL hoofdauteur VAL Haar, Jacob Everard ter Haar 1922-1998 COL 2e auteur VAL Mazur, Bas Mazur	COL titel VAL De @vreemde passagier	1
COL titel VAL Het @kleine reuzeboekje COL ondertitel VAL moppen	COL titel VAL Het @grote vraag- en antwoordenboek van de dieren	1
COL titel VAL Het @kleine reuzeboekje COL ondertitel VAL moppen	COL titel VAL De @dochters van Lucius COL hoofdauteur VAL Peters, Karin Peters	1
COL titel VAL Die @Bremer Stadtmusikanten COL ondertitel VAL ein märchen der Gebrüder Grimm COL hoofdauteur VAL Grimm, Jacob Ludwig Carl Grimm 1785-1863 COL 2e auteur VAL Fischer	COL titel VAL @Moed & overmoed COL ondertitel VAL nieuwe Vlaamse verhalen COL 2e auteur VAL Sainte Foy, Anne De Sainte Foy	1
COL titel VAL @Kun je nog zingen, zing dan mee! COL ondertitel VAL honderd zes en veertig algemeen bekende schoolliederen COL 2e auteur VAL Veldkamp, Jan Veldkamp 1868-1946 COL 2e auteur VAL Boer, Klaas de Boer 1865-1943 COL 2e auteur VAL Jonker, P. Jonker COL editie VAL 38e dr	COL titel VAL @Voelen en aaien en tellen met Muis COL hoofdauteur VAL Cousins, Elizabeth Cousins 1964- COL editie VAL 1e dr COL vertaling van VAL Maisy's twinkly crinkly counting book. - London : Walker Books, 2004	1
COL titel VAL Het @jaar rond COL ondertitel VAL tekeningen en versjes van Rie Cramer COL hoofdauteur VAL Cramer, Marie Cramer 1887-1977	COL titel VAL @Okkie weet raad COL hoofdauteur VAL Roggeveen, Leonard Roggeveen 1898-1959 COL editie VAL 11e dr	1
COL titel VAL De @geur van heimwee COL hoofdauteur VAL Thijssing-Boer, Henny Thijssing-Boer 1933-2011	COL titel VAL @Helden onder elkaar COL ondertitel VAL de avonturen van acht kinderen met hun favoriete sportheld COL 2e auteur VAL Schutten, Jan Paul Schutten 1970-	1
COL titel VAL @Geef je dromen niet op COL hoofdauteur VAL Peters, Karin Peters COL auteur/primair VAL Peters	COL titel VAL @Nedostajati COL hoofdauteur VAL Telehen, Antonius Otto Hermannus Tellegen 1941- COL 2e auteur VAL Petrović van der Leeuw, Olivera Petrović COL vertaling van VAL Toen niemand iets te doen had. - Amsterdam : Querido, 1987 COL vertaling van VAL Langzaam, zo snel als zij konden. - Amsterdam : Querido, 1989 COL vertaling van VAL Misschien waren zij nergens. - Amsterdam : Querido, 1991 COL vertaling van VAL Bijna iedereen kon omvallen. - Amsterdam : Querido, 1993	1
COL titel VAL Het @verborgen kleinood COL ondertitel VAL eene geschiedenis voor jonge meisjes COL 2e auteur VAL Meerten, geb. Schilperoort, Anna Barbara van Meerten-Schilperoort 1778-1853	COL titel VAL @Duiken COL 2e auteur VAL Hermans, Arthur Hermans COL 2e auteur VAL Aarsen, Rob Aarsen COL 2e auteur VAL Schoonhoven, HES van Schoonhoven COL 2e auteur VAL Heuvelmans, John Heuvelmans COL editie VAL 1e ed	1
COL titel VAL @Sprookjes COL 2e auteur VAL Goeverneur, Johan Jacob Antonie Goeverneur 1809-1889	COL titel VAL @Walt Disney's Alice in Wonderland COL 2e auteur VAL Disney, Walter Elias Disney 1901-1966 COL 2e auteur VAL Gonzales, Manuel Gonzales COL editie VAL 1e dr	1
COL titel VAL Het @jaar van de maagden COL hoofdauteur VAL Cookson, Catherine Anne Cookson 1906-1998 COL 2e auteur VAL Mons, Annet Mons COL vertaling van VAL The year of the virgins. - London [etc.] : Bantam Press, cop. 1993	COL titel VAL @5 mei 1945 Haarlem	1
COL titel VAL @Nooit meer slapen COL hoofdauteur VAL Hermans, Willem Frederik Hermans 1921-1995	COL titel VAL De @familie Fanshawe COL 2e auteur VAL J., G.J.	1
COL titel VAL De @koperen tuin COL hoofdauteur VAL Vestdijk, Simon Vestdijk 1898-1971	COL titel VAL @Mûske sil te kampearen COL hoofdauteur VAL Cousins, Elizabeth Cousins 1964- COL 2e auteur VAL Wijk, Gerda van der Wijk COL vertaling van VAL Maisy goes camping. - London : Walker, 2004	1
COL titel VAL De @aanslag COL hoofdauteur VAL Mulisch, Harry Kurt Victor Mulisch 1927-2010 COL 2e auteur VAL Voorsmit, Patty Voorsmit COL editie VAL 34e dr	COL titel VAL @Varken op een ladder COL ondertitel VAL een verhaal over vroeger COL 2e auteur VAL T., Hajo T. COL 2e auteur VAL Adrichem, Ria van Adrichem COL editie VAL 3e gew. dr COL Eerder verschenen o.d.t. VAL Zwientje slachten. - 1988	1
COL titel VAL De @grote verhalenparade COL 2e auteur VAL Cooling, Wendy Cooling COL 2e auteur VAL Dann, Penny Dann COL 2e auteur VAL Delden, Elizabeth van Delden 1942- COL vertaling van VAL Read me a story, please. - London : Orion Children's Books, cop. 1998	COL titel VAL @Marten Toonder's Heer Bommel en Tom Poes in Heer Bommel en de goede gedachte COL hoofdauteur VAL Toonder, Marten Toonder 1912-2005	1
COL titel VAL @Waar is Dikkie Dik? COL hoofdauteur VAL Boeke, Henriëtte Boeke 1948- COL 2e auteur VAL Norden, Arthur van Norden 1947- COL editie VAL 1e dr COL auteur/primair VAL Boeke	COL titel VAL @Piraten! COL ondertitel VAL een boek vol (zee)roversverhalen COL 2e auteur VAL Schrijnemakers, John Schrijnemakers COL 2e auteur VAL Meijer, Marja Meijer 1966-	1
COL titel VAL @Harten in Atlantis COL hoofdauteur VAL King, Stephen Edwin King 1947- COL 2e auteur VAL Kuipers, Hugo Kuipers 1954-2013 COL vertaling van VAL Hearts in Atlantis. - London : Hodder & Stoughton, 1999 COL auteur/primair VAL King	COL titel VAL Het @varken dat spaarvarken wilde zijn COL hoofdauteur VAL Diekmann, Maria Hendrika Jozina Diekmann 1925-2017	1
COL titel VAL @Terugzien in duisternis COL hoofdauteur VAL Rendell, Ruth Rendell 1930-2015 COL 2e auteur VAL Hazenberg, Annelies Hazenberg COL editie VAL 2e dr COL vertaling van VAL A dark-adapted eye. - Penguin Books, 1986	COL titel VAL @Reizen en lotgevallen van kapitein Hatteras: de ijswoestijn COL hoofdauteur VAL Verne, Jules Gabriel Verne 1828-1905 COL editie VAL 2e dr COL vertaling van VAL Voyages et aventures du capitaine Hatteras. - 1866	1
COL titel VAL Een @kerstverhaal COL hoofdauteur VAL Dickens, Charles John Huffam Dickens 1812-1870 COL 2e auteur VAL Altena, Ernst Rudolf van Altena 1933-1999 COL 2e auteur VAL Innocenti, Roberto Innocenti 1940- COL vertaling van VAL A Christmas carol. - 1843	COL titel VAL Le @travail et la paresse	1
COL titel VAL De @afgewezen bruid COL hoofdauteur VAL Peters, Karin Peters	COL titel VAL De @tijger in de ton	1
COL titel VAL Een @bruidsboeket als symbool COL hoofdauteur VAL Thijssing-Boer, Henny Thijssing-Boer 1933-2011 COL auteur/primair VAL Thijssing-Boer	COL titel VAL @Vertel mij wat! COL ondertitel VAL verhalen voor de brugklas en de tweede klas van het voortgezet onderwijs COL 2e auteur VAL Heerze, J.H. Heerze 1934-2020	1
COL titel VAL @Spelen COL hoofdauteur VAL Bruna, Hendrik Magdalenus Bruna 1927-2017	COL titel VAL @Alcohol COL 2e auteur VAL Bijsterbosch, H. Bijsterbosch	1
COL titel VAL @Welterusten Nijntje COL hoofdauteur VAL Bruna, Hendrik Magdalenus Bruna 1927-2017	COL titel VAL De @wonderstraal, gevolgd door Tien uren op jacht COL hoofdauteur VAL Verne, Jules Gabriel Verne 1828-1905 COL vertaling van VAL Le rayon vert, suivi de Dix Heures en chasse.	1
COL titel VAL @Tom Poes vertellingen COL hoofdauteur VAL Toonder, Marten Toonder 1912-2005	COL titel VAL @Merlin le prophète, ou le livre du Graal COL ondertitel VAL roman du XIIIe siècle COL 2e auteur VAL Baumgartner, Emmanuèle Baumgartner 1940-2005	1
COL titel VAL Les @oeufs de Pâque COL ondertitel VAL conte pour les enfants COL hoofdauteur VAL Schmid, Johann Christoph Friedrich von Schmid 1768-1854	COL titel VAL De @vrouw in het zwart COL hoofdauteur VAL Thijssing-Boer, Henny Thijssing-Boer 1933-2011	1
COL titel VAL De @baby COL 2e auteur VAL Andel, Lydia van Andel COL 2e auteur VAL Blokland, Cherouke Blokland COL 2e auteur VAL Aarsen, Margot van Aarsen COL 2e auteur VAL Spoelstra, Anky Spoelstra COL editie VAL 1e dr	COL titel VAL Het @grote sprookjesboek voor groot en klein COL hoofdauteur VAL Busser, Marianne Busser 1958-2025 COL 2e auteur VAL Schröder, Ron Schröder 1958- COL 2e auteur VAL Stam, Dagmar Stam 1945- COL editie VAL Tweede druk	1
COL titel VAL De @kunstenaar COL 2e auteur VAL Andel, Lydia van Andel COL 2e auteur VAL Blokland, Cherouke Blokland COL 2e auteur VAL Arkel, Freek van Arkel 1959-2020 COL 2e auteur VAL Spier, Rob Spier 1943- COL editie VAL 1e dr	COL titel VAL 'n @Heel jaar rond COL ondertitel VAL in een boekje bont!	1
COL titel VAL De @jonge matroos, of God hoort het gebed van een bang gemoed	COL titel VAL @Chanoine C. Schmid conte Jean et Marie ou les fruits d'une bonne éducation COL hoofdauteur VAL Schmid, Johann Christoph Friedrich von Schmid 1768-1854 COL 2e auteur VAL Macker, abbé Macker	1
COL titel VAL @Oetje Veldhuizen en andere verhalen COL 2e auteur VAL Kok, Truida Kok 1869-1949 COL 2e auteur VAL Andriessen, Suzanna Maria Andriessen 1850-1924 COL 2e auteur VAL Waals, Fredericus Johannes van der Waals 1897-1986 COL editie VAL 2e dr	COL titel VAL @Schneewittchen COL hoofdauteur VAL Bruna, Hendrik Magdalenus Bruna 1927-2017 COL editie VAL Dritte Auflage COL vertaling van VAL Sneeuwwitje. - Utrecht : Bruna & Zoon, 1966	1
COL titel VAL @Bedtijd voor Muis COL hoofdauteur VAL Cousins, Elizabeth Cousins 1964- COL 2e auteur VAL Willis, Jeanne Mary Willis 1959- COL vertaling van VAL Maisy's bedtime. - London : Walker Books, cop. 1999	COL titel VAL @Bilibom's zeiltocht	1
COL titel VAL @Muis verkleedt zich COL hoofdauteur VAL Cousins, Elizabeth Cousins 1964- COL 2e auteur VAL Willis, Jeanne Mary Willis 1959- COL vertaling van VAL Maisy dresses up. - London : Walker Books, cop. 1999	COL titel VAL De @padvinders van Duinwijk COL hoofdauteur VAL Abkoude, Christiaan Frederik van Abkoude 1880-1960 COL 2e auteur VAL Bruin, Wilhelmus Karel de Bruin 1871-1945 COL editie VAL 4e dr	1
COL titel VAL The @tale of Jemina Puddle-Duck COL hoofdauteur VAL Potter, Helen Beatrix Potter 1866-1943	COL titel VAL @Sinterklaasje bonne bonne bonne COL 2e auteur VAL Cramer, Marie Cramer 1887-1977 COL 2e auteur VAL B., B.	1
COL titel VAL The @tale of Tom Kitten COL hoofdauteur VAL Potter, Helen Beatrix Potter 1866-1943	COL titel VAL @Komt er nog wat van? COL ondertitel VAL jeugdzondagmap 1990 COL 2e auteur VAL Stern, Eveline Stern	1
COL titel VAL The @tale of Benjamin Bunny COL hoofdauteur VAL Potter, Helen Beatrix Potter 1866-1943	COL titel VAL Een @lastige leeuw COL ondertitel VAL een verhaaltje voor kinderen COL hoofdauteur VAL Gerdes, Eduard Gerdes 1821-1898	1
COL titel VAL The @tale of squirrel Nutkin COL hoofdauteur VAL Potter, Helen Beatrix Potter 1866-1943	COL titel VAL @Alle beestjes helpen COL 2e auteur VAL Gelder, Mariëtte van Gelder	1
COL titel VAL The @tale of Peter Rabbit COL hoofdauteur VAL Potter, Helen Beatrix Potter 1866-1943	COL titel VAL @Pussy Nell COL hoofdauteur VAL Bruna, Hendrik Magdalenus Bruna 1927-2017 COL editie VAL Reprint COL vertaling van VAL Poesje Nel. - Utrecht : A.W. Bruna & Zoon, 1959	1
COL titel VAL The @tale of Peter Rabbit COL hoofdauteur VAL Potter, Helen Beatrix Potter 1866-1943	COL titel VAL @Pim, Pam, Pom en de boze heks	1
COL titel VAL @Met hart en ziel COL ondertitel VAL wijze verhalen van alle tijden COL 2e auteur VAL Feldman, Christina Feldman COL 2e auteur VAL Kornfield, Jack Kornfield 1945- COL 2e auteur VAL Pijpers, Rob Pijpers COL editie VAL 2e dr COL vertaling van VAL Stories of the spirit, stories of the heart : parables for the spiritual path from around the world. - San Francisco : HarperSanFrancisco, 1991	COL titel VAL @Aan den weg der vreugde COL hoofdauteur VAL Couperus, Louis Marie Anne Couperus 1863-1923	1
COL titel VAL @Klein detail COL hoofdauteur VAL Coben, Harlan Coben 1962- COL 2e auteur VAL Franci-Ekeler, Elisabeth Franci-Ekeler COL vertaling van VAL The final detail. - New York : Delacorte Press, cop. 1999	COL titel VAL @Dodenwake COL hoofdauteur VAL King, Stephen Edwin King 1947- COL 2e auteur VAL Bakker, Margot Bakker COL vertaling van VAL Pet sematary. - Garden City, N.Y. : Doubleday, 1983 COL auteur/primair VAL King	1
COL titel VAL @Mio, mijn Mio COL hoofdauteur VAL Lindgren, Astrid Anna Emilia Lindgren 1907-2002 COL 2e auteur VAL Ferwerda, Saskia Ferwerda 1910-1984 COL 2e auteur VAL Egeraat, Els van Egeraat 1960- COL vertaling van VAL Mio, min Mio. - Stockholm : Rabén & Sjögren, 1954	COL titel VAL @Berburu ajam hutan ... COL 2e auteur VAL Endang J.N COL Verscheen o.d.t. VAL Supplement van het blad "Si-Kuntjung":	1
COL titel VAL @Weg met die krokodil! COL hoofdauteur VAL Loon, Paulus Stephanus Elisabeth Lambertus Maria van Loon 1955- COL 2e auteur VAL Overwater, Georgien Overwater 1958-	COL titel VAL @Onder moeders vleugels COL hoofdauteur VAL Alcott, Louisa May Alcott 1832-1888 COL 2e auteur VAL _, Almine, Almine COL editie VAL 10e geheel herz. dr COL vertaling van VAL Little women, or, Meg, Jo, Beth and Amy. - Boston : Roberts, 1868	1
COL titel VAL @Ingelijst COL ondertitel VAL verhalen van Annie M.G. Schmidt, Jaap ter Haar, Marianne Keser en Els Pelgrom COL 2e auteur VAL Schmidt, Anna Maria Geertruida Schmidt 1911-1995	COL titel VAL @Zestig COL ondertitel VAL verhalen COL 2e auteur VAL Oster, Annemarie Oster 1942- COL 2e auteur VAL Hoefnagels, Jacqueline Hoefnagels	1
COL titel VAL @Mens te koop COL hoofdauteur VAL Diekmann, Maria Hendrika Jozina Diekmann 1925-2017 COL 2e auteur VAL Wilde, Dirk de Wilde 1905-1994 COL Eerder verschenen als schooluitg. o.d.t. VAL Geen mens is van de ander	COL titel VAL De @tocht naar Rusland, of Het begin van den val van 't Keizerrijk, 1812 COL hoofdauteur VAL Andriessen, Pieter Jacob Andriessen 1815-1877 COL editie VAL 2e dr	1
COL titel VAL @Koning van Katoren COL hoofdauteur VAL Terlouw, Jan Cornelis Terlouw 1931- COL 2e auteur VAL Maat, Dick van der Maat 1948-	COL titel VAL @Duistere machten COL ondertitel VAL griezelverhalen COL 2e auteur VAL Loeb, Peter Loeb 1954-	1
COL titel VAL @Katten vangen COL hoofdauteur VAL Kromhout, Rindert Kromhout 1958- COL 2e auteur VAL Jutte, Jan Jutte 1954-	COL titel VAL @Ik wil met je mee! COL hoofdauteur VAL Mansell, Jill Mansell 1957- COL 2e auteur VAL Borg, Marja Borg COL editie VAL Vijfde druk COL vertaling van VAL Maybe this time. - Londen : H Review, 2019	1
COL titel VAL @Ingelijst COL ondertitel VAL verhalen van Miep Diekmann, Jaap ter Haar, Arnold Lobel, Lydia Rood en Carry Slee COL 2e auteur VAL Diekmann, Maria Hendrika Jozina Diekmann 1925-2017	COL titel VAL @Wild west farm COL 2e auteur VAL Montford, C.E. Montford	1
COL titel VAL @Kruimeltje COL hoofdauteur VAL Abkoude, Christiaan Frederik van Abkoude 1880-1960 COL 2e auteur VAL Tulp, Herman Tulp 1955- COL editie VAL 70e dr	COL titel VAL @Hjalmar Söderberg i helfigur COL ondertitel VAL utställning på Kungl. biblioteket 5 juni - 16 september 1984 COL 2e auteur VAL Holmbäck, Bure Holmbäck 1923- COL 2e auteur VAL Söderberg, Hjalmar Emil Frederik Söderberg 1869-1941	1
COL titel VAL @Baken in de storm COL hoofdauteur VAL Peters, Karin Peters COL auteur/primair VAL Peters	COL titel VAL @Catherine Cooksons Belofte van geluk COL hoofdauteur VAL Cookson, Catherine Anne Cookson 1906-1998 COL 2e auteur VAL Goodwin, Rosie Goodwin COL 2e auteur VAL Muijlwijk, Margreet van Muijlwijk COL vertaling van VAL Tilly Trotter's legacy. - London : Headline, 2006	1
COL titel VAL Het @leven heeft voorrang COL hoofdauteur VAL Peters, Karin Peters COL editie VAL 1e dr COL auteur/primair VAL Peters	COL titel VAL @Kikker is jarig COL hoofdauteur VAL Velthuijs, Max Velthuijs 1923-2005 COL editie VAL Tweede druk	1
COL titel VAL Het @Trevayne verraad COL hoofdauteur VAL Ludlum, Robert Ludlum 1927-2001 COL 2e auteur VAL Bruning, Frans J. Bruning COL editie VAL 9e dr COL vertaling van VAL Trevayne. - New York : Delacorte Press, 1973	COL titel VAL @Kinderen van verre en nabij COL ondertitel VAL 120 unieke opnamen van internationaal bekende fotografen COL 2e auteur VAL Reich, Hanns Reich COL 2e auteur VAL Bouhuys, Maria Albertha Bouhuys 1927-2008	1
COL titel VAL De @verbroken verbinding COL hoofdauteur VAL Graaf, Anke de Graaf 1927-2019 COL editie VAL 1e dr	COL titel VAL De @meermin COL hoofdauteur VAL Haasse, Hélène Serafia Haasse 1918-2011	1
COL titel VAL Het @rode kippetje COL hoofdauteur VAL Velthuijs, Max Velthuijs 1923-2005	COL titel VAL @Wilde Bob COL hoofdauteur VAL Kieviet, Cornelis Johannes Kieviet 1858-1931 COL 2e auteur VAL Reinderhoff, Marie-Louise Reinderhoff 1903-1991 COL editie VAL Zesde druk	1
COL titel VAL @Pietje Bell COL hoofdauteur VAL Abkoude, Christiaan Frederik van Abkoude 1880-1960 COL 2e auteur VAL Rinke, Jan Frederik Rinke 1863-1922	COL titel VAL @1, 2, 3 COL ondertitel VAL leer tellen met Thomas! COL 2e auteur VAL Awdry, Wilbert Vere Awdry 1911-1997 COL vertaling van VAL Thomas' 1, 2, 3. - Gullane, cop. 2012	1
COL titel VAL @Ronja de roversdochter COL hoofdauteur VAL Lindgren, Astrid Anna Emilia Lindgren 1907-2002 COL 2e auteur VAL Törnqvist-Verschuur, Marguérite Elisabeth Verschuur 1935- COL 2e auteur VAL Wikland, Ilon Wikland 1930- COL vertaling van VAL Ronja rövardotter. - Stockholm : Rabén & Sjögren, 1981	COL titel VAL @Hoe laat is het? COL ondertitel VAL leren klok kijken met je eigen horloge! COL 2e auteur VAL Mongeau, Diane Mongeau COL 2e auteur VAL Brierley, Jane Brierley 1935- COL 2e auteur VAL Kemmenaar, Tonneke Kemmenaar	1
COL titel VAL Het @Medusa ultimatum COL hoofdauteur VAL Ludlum, Robert Ludlum 1927-2001 COL 2e auteur VAL Bruning, Frans J. Bruning COL editie VAL 11e dr COL vertaling van VAL The Bourne ultimatum. - New York : Random House, 1990 COL Vervolg op VAL Het Bourne bedrog	COL titel VAL Un @nouveau dans la ville COL ondertitel VAL roman COL hoofdauteur VAL Simenon, Georges Joseph Christian Simenon 1903-1989	1
COL titel VAL Het @woud der verwachting COL ondertitel VAL het leven van Charles van Orléans COL hoofdauteur VAL Haasse, Hélène Serafia Haasse 1918-2011 COL editie VAL 22e, uitgebr. dr	COL titel VAL @Te kust en te keur COL ondertitel VAL rijmpjes en vertellingen voor onze kleinen COL hoofdauteur VAL Louwerse, Pieter Louwerse 1840-1908	1
COL titel VAL @Katrientje COL hoofdauteur VAL Cramer, Marie Cramer 1887-1977	COL titel VAL @Roodkapje COL 2e auteur VAL Bosnia, Nella Bosnia	1
COL titel VAL @Kluchtspelen voor de Chineesche schimmen, geschikt voor kinderen COL ondertitel VAL met zang	COL titel VAL @Klein Duimpje COL 2e auteur VAL Gorde, Monique Gorde COL 2e auteur VAL Steenhoff, Jook Steenhoff 1905-1998	1
COL titel VAL De @reuzenkrokodil COL hoofdauteur VAL Dahl, Roald Dahl 1916-1990 COL 2e auteur VAL Blake, Quentin Saxby Blake 1932- COL 2e auteur VAL Freezer, Harriët Freezer COL editie VAL 11e, gew. dr COL vertaling van VAL The enormous crocodile. - London : Cape, 1978 COL auteur/primair VAL Dahl	COL titel VAL Die @sechs Schwäne COL 2e auteur VAL J., E. J. COL 2e auteur VAL Grimm, Jacob Ludwig Carl Grimm 1785-1863 COL 2e auteur VAL Grimm, Wilhelm Carl Grimm 1786-1859	1
COL titel VAL @Miffy in the snow COL hoofdauteur VAL Bruna, Hendrik Magdalenus Bruna 1927-2017 COL vertaling van VAL Nijntje in de sneeuw. - Utrecht : A. W. Bruna & Zoon, 1963	COL titel VAL @Moord in de Oriënt-Expres COL hoofdauteur VAL Christie, Agatha Christie 1890-1976 COL 2e auteur VAL Rijman, J. Rijman COL vertaling van VAL Murder on the Orient express. - 1933	1
COL titel VAL @Miffy at the seaside COL hoofdauteur VAL Bruna, Hendrik Magdalenus Bruna 1927-2017 COL vertaling van VAL Nijntje aan zee. - Utrecht : A. W. Bruna & Zoon, 1963	COL titel VAL De @reis om de wereld in 80 dagen COL hoofdauteur VAL Verne, Jules Gabriel Verne 1828-1905 COL 2e auteur VAL Keller, Gerard Keller 1829-1899 COL editie VAL 6e dr COL vertaling van VAL Le tour du monde en quatre-vingt jours. - 1872	1
COL titel VAL @Paviljoen 3 COL hoofdauteur VAL Konsalik, Heinz G. Konsalik COL 2e auteur VAL Amerongen, Jan van Amerongen 1939-1998 COL vertaling van VAL Männerstation. - Bayreuth : Hestia, 1964	COL titel VAL @Moord in de cafeteria COL ondertitel VAL oorspronkelijke Nederlandsche detectiveroman	1
COL titel VAL @Ochenebbisj COL ondertitel VAL verhalen en geintjes over het Amsterdamse getto (1870-1925) COL 2e auteur VAL Verhoeff, Maurits Verhoeff 1966- COL 2e auteur VAL Wierema, Thijs Wierema 1944- COL 2e auteur VAL Leydesdorff, Selma Leydesdorff 1949-	COL titel VAL @Peredur COL ondertitel VAL de zoon van Efrawg COL ondertitel VAL een Arthurvertelling uit het 14e-eeuwse Wales COL 2e auteur VAL Bijl, Peter van der Bijl COL vertaling van VAL The Mabinogion. - London : Dent, 1984	1
COL titel VAL @Slaap zacht COL ondertitel VAL de mooiste verhalen, liedjes en versjes voor het slapengaan COL 2e auteur VAL Becker, Paul De Becker	COL titel VAL De @prins op het verkeerde paard COL hoofdauteur VAL Mansell, Jill Mansell 1957- COL vertaling van VAL Falling for you. - London : Headline, ©2003	1
COL titel VAL @Märchen COL hoofdauteur VAL Andersen, Hans Christian Andersen 1805-1875 COL 2e auteur VAL Zwerger, Lisbeth Zwerger 1954- COL editie VAL 2. Aufl	COL titel VAL @Koddige prentjes voor de jeugd COL ondertitel VAL vermakelijk prentenboek	1
COL titel VAL De @bengels in het bos COL hoofdauteur VAL Hulst, Willem Gerrit van de Hulst 1879-1963 COL 2e auteur VAL Hulst, Rose Marijne van de Hulst 1953- COL 2e auteur VAL Hulst, Willem Gerrit van de Hulst 1917-2006 COL editie VAL 11e dr	COL titel VAL De @haas en de egel COL 2e auteur VAL Grimm, Jacob Ludwig Carl Grimm 1785-1863 COL 2e auteur VAL Grimm, Wilhelm Carl Grimm 1786-1859	1
COL titel VAL @Anneke en de sik COL hoofdauteur VAL Hulst, Willem Gerrit van de Hulst 1879-1963 COL 2e auteur VAL Hulst, Rose Marijne van de Hulst 1953- COL 2e auteur VAL Hulst, Willem Gerrit van de Hulst 1917-2006 COL editie VAL [18e dr.]	COL titel VAL De @heilige Jozef en het kind, dat zich tot de eerste H. Communie voorbereidt COL editie VAL 2e dr	1
COL titel VAL De @vrienden COL hoofdauteur VAL Graaf, Anke de Graaf 1927-2019	COL titel VAL Het @boek der uitvindingen	1
COL titel VAL @Jul i Bullerbyn COL hoofdauteur VAL Lindgren, Astrid Anna Emilia Lindgren 1907-2002 COL 2e auteur VAL Wikland	COL titel VAL @Wilde en tamme dieren COL 2e auteur VAL Keser, M.A.A. Keser 1932-	1
COL titel VAL De @lange weg naar huis COL hoofdauteur VAL Steel, Danielle Fernande Steel 1947- COL 2e auteur VAL Bronswijk, Ineke van Bronswijk COL vertaling van VAL The long road home. - Cop. 1998 COL auteur/primair VAL Steel	COL titel VAL @Geluiden COL ondertitel VAL opo sten COL ondertitel VAL een bloemlezing proza en poëzie van Surinaamse auteurs in Nederland COL 2e auteur VAL Ashruf, G.J. Ashruf	1
COL titel VAL De @nachtzuster COL ondertitel VAL spookverhalen van vrouwen COL 2e auteur VAL Blom, Tineke Blom COL vertaling van VAL The Virago book of ghost stories. - London : Virago, 1987 COL vertaling van VAL The Virago book of Victorian ghost stories. - London : Virago, 1988	COL titel VAL De @GVR COL hoofdauteur VAL Dahl, Roald Dahl 1916-1990 COL 2e auteur VAL Blake, Quentin Saxby Blake 1932- COL 2e auteur VAL Vriesendorp, Gerarde Hubèrte Vriesendorp 1940- COL editie VAL Zevenenzeventigste druk COL vertaling van VAL The BFG. - London : Cape, 1982	1
COL titel VAL @Op weg naar de hemel COL hoofdauteur VAL Dahl, Roald Dahl 1916-1990 COL 2e auteur VAL Hoog, Else Hoog 1937- COL editie VAL 43e dr COL vertaling van VAL Kiss kiss. - Harmondsworth : Penguin Books, 1959	COL titel VAL @Gelukkige uurtjes COL ondertitel VAL rijmpjes en vertelseltjes voor het kleine volkje COL hoofdauteur VAL Louwerse, Pieter Louwerse 1840-1908	1
COL titel VAL De @heilige biecht COL ondertitel VAL geschenk aan de lieve kinderen  van eenen Geestelijken Kindervriend COL editie VAL 3de dr	COL titel VAL @Nooit de buren bijten COL hoofdauteur VAL Loon, Paulus Stephanus Elisabeth Lambertus Maria van Loon 1955- COL 2e auteur VAL Fialkowski, Camila Fialkowski 1950- COL editie VAL 8e dr	1
COL titel VAL De @heilige biecht COL ondertitel VAL geschenk aan de lieve kinderen  van eenen Geestelijken Kindervriend	COL titel VAL De @avonden COL ondertitel VAL een winterverhaal COL hoofdauteur VAL Reve, Gerard Kornelis van het Reve 1923-2006 COL editie VAL 42e dr	1
COL titel VAL @Barnets första bok COL ondertitel VAL pekbok COL 2e auteur VAL Smedberg COL 2e auteur VAL Söderstam	COL titel VAL De @blik der oogen COL ondertitel VAL een verhaal voor jonge lieden COL hoofdauteur VAL Gerdes, Eduard Gerdes 1821-1898	1
COL titel VAL Het @aardig leven van Thijl Uilenspiegel COL ondertitel VAL waarin verhaald worden: niet alleen veele aardige en kluchtige poetsen en boeverijen, maar ook bijzonder zijne wonderlijke avonturen die hem gedurende zijn leven gebeurd zijn, zoo hier als in andere landen	COL titel VAL @Langs lijnen van geleidelijkheid COL hoofdauteur VAL Couperus, Louis Marie Anne Couperus 1863-1923 COL editie VAL 4e dr	1
COL titel VAL @Dierenvriendjes	COL titel VAL @Wij uit Bolderburen COL hoofdauteur VAL Lindgren, Astrid Anna Emilia Lindgren 1907-2002 COL 2e auteur VAL Clark, Sydia Clark COL 2e auteur VAL Egeraat, Els van Egeraat 1960- COL 2e auteur VAL Riaskoff, Dominique Riaskoff COL vertaling van VAL Alla vi barn i Bullerbyn. - Stockholm : Rabén & Sjögren Bokförlag COL vertaling van VAL Een keuze uit: Mera om oss barn i Bullerbyn. - Stockholm : Rabén & Sjögren Bokförlag	1
COL titel VAL @Moeders COL ondertitel VAL verhalen COL 2e auteur VAL Serdijn, Daniëlle Serdijn 1968-	COL titel VAL @Valkparkieten COL 2e auteur VAL Haak, Ruud Haak COL 2e auteur VAL Kramer, Edward Kramer	1
COL titel VAL @Babydieren	COL titel VAL @Biblische Geschichte für Kinder COL ondertitel VAL ein Auszug COL hoofdauteur VAL Schmid, Johann Christoph Friedrich von Schmid 1768-1854	1
COL titel VAL @Boerderijdieren	COL titel VAL @Nu 't leven in! COL ondertitel VAL briefsteller voor de 6de en 7de klas der Lagere School, kopscholen en cursussen voor vervolg onderwijs COL 2e auteur VAL Kouwe, Cornelis van der Kouwe COL editie VAL 4e dr	1
COL titel VAL De @boerderij COL hoofdauteur VAL Cousins, Elizabeth Cousins 1964- COL editie VAL 2e dr	COL titel VAL @Première voor twee COL hoofdauteur VAL Saris, Helena Barbara Wilhelmina Saris 1915-1999 COL 2e auteur VAL Herson, Herson	1
COL titel VAL @Heren van de thee COL hoofdauteur VAL Haasse, Hélène Serafia Haasse 1918-2011 COL editie VAL 45e dr	COL titel VAL @Floortje Bellefleur redt een hondje COL hoofdauteur VAL Grashoff, Cornelia Johanna Grashoff 1928-2004 COL 2e auteur VAL Veenhoven, Elisabeth Annie Veenhoven 1919-2001 COL editie VAL [1e druk]	1
COL titel VAL @Dit kleine geluk COL hoofdauteur VAL Thijssing-Boer, Henny Thijssing-Boer 1933-2011 COL editie VAL 1e dr COL auteur/primair VAL Thijssing-Boer	COL titel VAL @Jeugdverhalen	1
COL titel VAL @Speel en leer met Disney's Winnie de Poeh: getallen COL 2e auteur VAL Milne, Alan Alexander Milne 1882-1956 COL 2e auteur VAL Veldkamp, Tjibbe Veldkamp 1962- COL 2e auteur VAL Disney, Walter Elias Disney 1901-1966 COL editie VAL 1e dr	COL titel VAL De @avonturen van Peter en Leentje	1
COL titel VAL @Walt Disney's Een vrolijke kerst met Donald Duck COL 2e auteur VAL Disney, Walter Elias Disney 1901-1966	COL titel VAL De @wonderlyke reisgevallen van Maria Kinkons COL 2e auteur VAL M., A.G.L. M. COL 2e auteur VAL Broos, Antonius Jozef Maria Broos 1947-2024	1
COL titel VAL @Moeders mooiste COL ondertitel VAL verhalen van Nederlandse en Vlaamse schrijfsters COL 2e auteur VAL Bouwman, Maria Antoinette Bouwman 1929-2018 COL 2e auteur VAL Krouwel, Jacoba Cornelia Maria Krouwel 1925-2010 COL editie VAL [1e dr.]	COL titel VAL De @dokter COL hoofdauteur VAL Slegers, Liesbet Slegers 1975- COL editie VAL Tweede druk	1
COL titel VAL @Frog and a very special day COL hoofdauteur VAL Velthuijs, Max Velthuijs 1923-2005 COL vertaling van VAL Kikker en een heel bijzondere dag. - Amsterdam : Leopold, cop. 1999	COL titel VAL @Spekkie en Sproet en de vreemde ontvoering COL hoofdauteur VAL Hollander, Vivian den Hollander 1953- COL 2e auteur VAL Wit, Juliette de Wit 1958- COL editie VAL Vierde druk	1
COL titel VAL @Kikker en een heel bijzondere dag COL hoofdauteur VAL Velthuijs, Max Velthuijs 1923-2005	COL titel VAL @Met Heintje op de plassen COL hoofdauteur VAL Haar, Jacob Everard ter Haar 1922-1998 COL 2e auteur VAL Straaten, Gerard van Straaten 1924-2011	1
COL titel VAL @Misdaad op bezoek COL ondertitel VAL Hollandse misdaadverhalen COL 2e auteur VAL Simenon, Georges Joseph Christian Simenon 1903-1989	COL titel VAL @Hard en teder COL ondertitel VAL Nederlandse en Vlaamse erotica COL 2e auteur VAL Blondeau, Thomas Blondeau 1978-2013	1
COL titel VAL @Misschien wisten zij alles COL ondertitel VAL 313 verhalen over de eekhoorn en de andere dieren COL hoofdauteur VAL Tellegen, Antonius Otto Hermannus Tellegen 1941- COL 2e auteur VAL Post, Hermance Berendina Post 1925-2013 COL editie VAL 5e, vermeerderde dr	COL titel VAL @Walt Disney's Oom Dagobert 60 jaar in Duckstad COL 2e auteur VAL Disney, Walter Elias Disney 1901-1966 COL 2e auteur VAL Barks, Carl Barks 1901-2000 COL 2e auteur VAL Jippes, Daan Jippes 1945- COL editie VAL 1e dr	1
COL titel VAL @Oude rijmpjes COL ondertitel VAL illustraties van Marijke Doornekamp COL 2e auteur VAL Blankevoort, Loek van de Blankevoort COL 2e auteur VAL Brands, Nel M. Brands COL 2e auteur VAL Doornekamp COL editie VAL 7e dr	COL titel VAL @Voor de dag van morgen COL 2e auteur VAL Bouman, Machteld Bouman COL 2e auteur VAL Voskuil, Johannes Jacobus Voskuil 1926-2008	1
COL titel VAL Le @quadrille des enfans, ou Systême nouveau de lecture COL editie VAL 10e édition	COL titel VAL Le @clan des Ostendais COL ondertitel VAL roman COL hoofdauteur VAL Simenon, Georges Joseph Christian Simenon 1903-1989	1
COL titel VAL De @huishoudschool in rep en roer COL hoofdauteur VAL Hagers, Freddy Hagers COL 2e auteur VAL Behrens, H.G.M. Behrens 1937- COL editie VAL 13e dr	COL titel VAL Het @liefst wil ik een wonder COL ondertitel VAL gedichten voor kinderen van 6 tot 106 COL 2e auteur VAL Goes, Mia Goes COL 2e auteur VAL Hooijdonk, Margje van Hooijdonk	1
COL titel VAL @Met kroontjespen of toetsenbord COL 2e auteur VAL Kakebeeke, H.H.M. Kakebeeke 1932-2014	COL titel VAL Het @bestuurbare eiland COL hoofdauteur VAL Verne, Jules Gabriel Verne 1828-1905	1
COL titel VAL @Loods aan boord COL hoofdauteur VAL Norel, Klaas Norel 1899-1971	COL titel VAL @Bil en Wil COL ondertitel VAL vrienden voor altijd COL hoofdauteur VAL Kromhout, Rindert Kromhout 1958-	1
COL titel VAL @Ronnie van de pony-wei COL hoofdauteur VAL Hagers, Freddy Hagers COL 2e auteur VAL Giffen, Rudy van Giffen 1929-2005	COL titel VAL De @regenboog COL ondertitel VAL Russische volkssprookjes COL ondertitel VAL kinderliedjes en versjes COL 2e auteur VAL Wasnetsov, Jurij Alekseevič Vasnecov 1900-1973 COL 2e auteur VAL Pieters, R.E. Pieters COL 2e auteur VAL Tokmakov, Lev Tokmakov 1928- COL vertaling van VAL Padura : Russkie narodnye skazki, presenki, poteški COL vertaling van VAL Падура : Русские народные сказки, пресенки, потешки	1
COL titel VAL Die @drei Bären COL hoofdauteur VAL Tolstoi, L.N. Tolstoj 1828-1910 COL 2e auteur VAL Vormstein COL 2e auteur VAL Baumann	COL titel VAL @Bambi en het verdwaalde eekhoorntje COL 2e auteur VAL Disney, Walter Elias Disney 1901-1966 COL 2e auteur VAL Ruitenbeek, Simone Ruitenbeek COL editie VAL Nieuwe dr COL vertaling van VAL Bambi and the Lost Squirrel	1
COL titel VAL @Straten zonder einde COL hoofdauteur VAL Konsalik, Heinz G. Konsalik COL 2e auteur VAL Wansem, J. van der Wansem COL vertaling van VAL Die Strasse ohne Ende. - Bayreurth : Hestia, 1972	COL titel VAL @Marijn bij de Lorredraaiers COL hoofdauteur VAL Diekmann, Maria Hendrika Jozina Diekmann 1925-2017 COL 2e auteur VAL Wilde, Dirk de Wilde 1905-1994 COL editie VAL 3e dr	1
COL titel VAL @Nevel in de lente COL hoofdauteur VAL Saris, Helena Barbara Wilhelmina Saris 1915-1999	COL titel VAL De @schone slaapster	1
COL titel VAL @Letta's bestemming COL hoofdauteur VAL Burgers-Drost, Julia Eveline Jolanda Burgers-Drost 1938-2013	COL titel VAL @Narcissus op vrijersvoeten COL hoofdauteur VAL Vestdijk, Simon Vestdijk 1898-1971	1
COL titel VAL Het @gestolen geluk COL hoofdauteur VAL Konsalik, Heinz G. Konsalik COL 2e auteur VAL Grasman, Gerard Grasman 1940- COL editie VAL 2e dr COL vertaling van VAL Das gestohlene Glück. - Bayreuth : Hestia, cop. 1968. - Oorspr. verschenen onder het pseud. Jens Bekker en o.d.t.: Die sündige Nacht	COL titel VAL @Walt Disney's een vrolijke kerst met Donald Duck COL 2e auteur VAL Disney, Walter Elias Disney 1901-1966	1
COL titel VAL @Koning Arthur en de ridders van de tafelronde COL ondertitel VAL geschiedenissen uit ouden tijd COL editie VAL 3e dr	COL titel VAL @Onze dieren	1
COL titel VAL @Wij drieën COL hoofdauteur VAL Saris, Helena Barbara Wilhelmina Saris 1915-1999 COL editie VAL 1e dr	COL titel VAL @Bleyle Bilderbuch COL ondertitel VAL Eduard zum Felde/Esenach, Kaufhaus Wolfsschlucht COL 2e auteur VAL Midderigh-Bokhorst, Johanna Berhardina Midderigh-Bokhorst 1880-1972	1
COL titel VAL Een @nacht vol verleiding COL hoofdauteur VAL Konsalik, Heinz G. Konsalik COL 2e auteur VAL Rijsbergen, Miep Rijsbergen COL editie VAL 3e dr COL vertaling van VAL Nacht der Versuchung. - Bayreuth : Hestia, 1985	COL titel VAL De @geleerde hond COL vertaling van VAL The comic adventures of Old Mother Hubbard and her dog	1
COL titel VAL @Als de zon wil schijnen COL hoofdauteur VAL Cookson, Catherine Anne Cookson 1906-1998 COL 2e auteur VAL Mons, Annet Mons COL editie VAL 5e dr COL vertaling van VAL The tinker's girl. - London [etc.] : Bantam Press, 1994	COL titel VAL De @gouden dorpel COL ondertitel VAL leesboek voor de christelijke school COL 2e auteur VAL Kooyman COL 2e auteur VAL Stronkhorst COL editie VAL 6e dr	1
COL titel VAL @ABC	COL titel VAL @Ik en mijzelf COL hoofdauteur VAL Tellegen, Antonius Otto Hermannus Tellegen 1941- COL 2e auteur VAL Godon, Ingrid Godon 1958-	1
COL titel VAL @Christine COL hoofdauteur VAL Cookson, Catherine Anne Cookson 1906-1998 COL 2e auteur VAL Havander, Emma Havander COL vertaling van VAL Fenwick houses. - London : Macdonald, 1977	COL titel VAL @Losprijs COL hoofdauteur VAL Rendell, Ruth Rendell 1930-2015 COL 2e auteur VAL Kuipers, Hugo Kuipers 1954-2013 COL editie VAL 3e dr COL vertaling van VAL Road rage. - London : Hutchinson, 1997	1
COL titel VAL @Vacantie COL 2e auteur VAL Gantzert, Adolf Carl Eduard Gantzert 1906-1968	COL titel VAL De @nacht COL 2e auteur VAL Goes, Mia Goes COL 2e auteur VAL Vorst, Lieke van der Vorst COL 2e auteur VAL Bebber, Margriet van Bebber 1948-	1
COL titel VAL @Mies COL 2e auteur VAL Gantzert, Adolf Carl Eduard Gantzert 1906-1968	COL titel VAL @Joessoef en het toverpaard Bollekol COL hoofdauteur VAL Hildebrand, Annettes Dideric Hildebrand 1907-1977 COL 2e auteur VAL Lutz, Johannes Hermanus Lutz 1888-1957	1
COL titel VAL @Winterboek COL 2e auteur VAL Hulsebosch, Tom Hulsebosch 1909-1986 COL 2e auteur VAL Goris, Rien Goris COL 2e auteur VAL Marée, Piet Marée 1903-1999	COL titel VAL @Nederlandsche historieprenten (1555-1900) COL ondertitel VAL platen-atlas ten gebruike bij de studie der vaderlandsche geschiedenis COL 2e auteur VAL Rijn, Gerrit van Rijn 1846-1912 COL 2e auteur VAL Kernkamp, Gerhard Wilhelm Kernkamp 1864-1943	1
COL titel VAL @O, kom er eens kijken COL ondertitel VAL oude en nieuwe Sinterklaasliedjes in hun oorspronkelijke versie COL 2e auteur VAL Aarts, Cornelis Johannes Jacobus Aarts 1947- COL 2e auteur VAL Etten, Maria Christina van Etten 1948- COL editie VAL 3e, verb. dr	COL titel VAL @Aanvallen! COL hoofdauteur VAL Hollander, Vivian den Hollander 1953- COL 2e auteur VAL Straaten, Harmen van Straaten 1961- COL editie VAL 6e dr	1
COL titel VAL @Lina's keuze COL ondertitel VAL eene kerstvertelling COL hoofdauteur VAL Alcott, Louisa May Alcott 1832-1888 COL 2e auteur VAL A., Maria Henriëtte Koorders-Boeke 1837-1887	COL titel VAL @Nijntje voelboek COL hoofdauteur VAL Bruna, Hendrik Magdalenus Bruna 1927-2017 COL editie VAL 1st ed COL auteur/primair VAL Bruna	1
COL titel VAL De @huishoudschool in volle actie COL hoofdauteur VAL Hagers, Freddy Hagers COL 2e auteur VAL Borrebach, Henri Carl Johan Elisa Borrebach 1903-1991 COL editie VAL 11e dr	COL titel VAL @Treintje tuut-tuut COL 2e auteur VAL Belle, Sante de Belle	1
COL titel VAL @Vrolijke vrienden COL ondertitel VAL spelletjes en liedjes COL 2e auteur VAL Bos, Ans M. Bos COL 2e auteur VAL Haas, Marie J. de Haas COL 2e auteur VAL Bottema, Hillegonda Bottema 1913-1968	COL titel VAL @Kort Italiaans COL ondertitel VAL verhalen van hedendaagse Italiaanse schrijvers COL 2e auteur VAL La Porta, Filippo La Porta 1952-	1
COL titel VAL @Kleuters kijken en luisteren COL ondertitel VAL feestjes, poppenkast, schimmenspel enz. COL 2e auteur VAL Groothoff, Ans C. Groothoff COL 2e auteur VAL Bouman, F.H. Kesler-Bouman COL 2e auteur VAL Bouman, I.J. Swart-Bouman	COL titel VAL De @Reuzenkrokodil COL hoofdauteur VAL Dahl, Roald Dahl 1916-1990 COL 2e auteur VAL Blake, Quentin Saxby Blake 1932- COL 2e auteur VAL Freezer, Harriët Freezer COL editie VAL Negenentwintigste druk COL vertaling van VAL The enormous crocodile. - London : Jonathan Cape, 1978	1
COL titel VAL @Voor 't jonge volkje COL ondertitel VAL verhalen COL 2e auteur VAL Heijermans, Ida Sarah Heijermans 1866-1943	COL titel VAL @Fairy tales COL hoofdauteur VAL Andersen, Hans Christian Andersen 1805-1875 COL 2e auteur VAL MacGregor, Mary MacGregor COL 2e auteur VAL Allen, Olive Allen	1
COL titel VAL @Ver van huis COL ondertitel VAL vertellingen voor 't jonge volkje COL hoofdauteur VAL Louwerse, Pieter Louwerse 1840-1908 COL 2e auteur VAL Sluyters, Johannes Carolus Bernardus Sluijters 1881-1957 COL editie VAL 3e verb. dr	COL titel VAL The @definitive Dr. Jekyll and Mr. Hyde companion COL 2e auteur VAL Geduld, Harry Maurice Geduld	1
COL titel VAL @Gedichtjes voor de lieve jeugd COL ondertitel VAL met gekleurde plaatjes COL editie VAL 4e verb. dr	COL titel VAL @À la recherche du bonheur COL hoofdauteur VAL Tolstoj, L.N. Tolstoj 1828-1910 COL 2e auteur VAL Halpérine-Kaminsky, Ely Halpérine-Kaminsky 1858-1936	1
COL titel VAL @Mijn vader COL hoofdauteur VAL Tellegen, Antonius Otto Hermannus Tellegen 1941- COL 2e auteur VAL Berner, Rotraut Susanne Berner 1948- COL editie VAL 4e dr	COL titel VAL Het @verdwaalde prinsesje	1
COL titel VAL @En het geschiedde in die dagen... COL ondertitel VAL winterverhalen van alle tijden op de drempel van het nieuwe jaar COL 2e auteur VAL Burgers-Drost, Julia Eveline Jolanda Burgers-Drost 1938-2013	COL titel VAL @Jungle Boek COL 2e auteur VAL Welply, Michael Welply COL 2e auteur VAL Menthon, Alexia de Menthon COL 2e auteur VAL Kipling, Joseph Rudyard Kipling 1865-1936 COL 2e auteur VAL Mulder, Suzanne Mulder COL 2e auteur VAL Hauer, Christel Hauer COL 2e auteur VAL Twain, Mark Twain	1
COL titel VAL @Kijkbijbel COL ondertitel VAL verhalen uit het Oude en het Nieuwe Testament COL 2e auteur VAL Kort, Cornelis Jacobus de Kort 1934-2022 COL editie VAL 10e dr COL Oorspr. verschenen in 28 dl. o.d.t. VAL Wat de bijbel ons vertelt. - 1966-1980	COL titel VAL @Spelende kinderen	1
COL titel VAL @St.Nicolaas	COL titel VAL @Misschien zijn we een ziekte COL 2e auteur VAL Teck, Lut Teck COL 2e auteur VAL Dhont, Famke Dhont	1
COL titel VAL @Vriendschap COL ondertitel VAL de mooiste verhalen COL 2e auteur VAL Verhoeven, Edwin Verhoeven 1971-	COL titel VAL @Bijna menselijk en andere verhalen COL hoofdauteur VAL Rendell, Ruth Rendell 1930-2015 COL 2e auteur VAL Bommel-van Terwisga, A.B.H. van Bommel-van Terwisga COL editie VAL 1e dr COL vertaling van VAL The fallen curtain and other stories. - London : Hutchinson London, 1976	1
COL titel VAL De @zwarte wolf COL hoofdauteur VAL Gerdes, Eduard Gerdes 1821-1898 COL 2e auteur VAL Bos, Gerardus Johannes Bos 1825-1898 COL editie VAL 4e dr	COL titel VAL @Adolf, of COL ondertitel VAL De goede zoon	1
COL titel VAL @Op de boerderij COL 2e auteur VAL Dear, Neville Dear	COL titel VAL @Dribbel naar het circus COL hoofdauteur VAL Hill, Eric Hill 1927-2014 COL editie VAL 9e dr COL vertaling van VAL Spot goes to the circus. - London : Heinemann, cop. 1986	1
COL titel VAL De @kinderen van den zoetelaar, of Nederland gedurende de eerste regeeringsjaren van Prins Willem III COL hoofdauteur VAL Andriessen, Pieter Jacob Andriessen 1815-1877 COL 2e auteur VAL Wetstein Pfister, Jan Jacob Rudolf de Wetstein Pfister 1866-1937 COL editie VAL 5e dr	COL titel VAL →Tò @fántasma mífa⇋ COL hoofdauteur VAL Bruna, Hendrik Magdalenus Bruna 1927-2017 COL 2e auteur VAL Plaat, Annemieke van der Plaat COL vertaling van VAL Het spook Nijntje. - Amsterdam : Mercis, 2001	1
COL titel VAL Het @geheim van den geus COL ondertitel VAL een verhaal uit den Tachtigjarigen oorlog COL hoofdauteur VAL Gerdes, Eduard Gerdes 1821-1898 COL 2e auteur VAL Overbeek, Gijsbertus Johannes van Overbeek 1882-1947 COL editie VAL 4e dr	COL titel VAL Het @slot op den Hoef COL ondertitel VAL een verhaal uit den tijd van Ada van Holland COL hoofdauteur VAL Kieviet, Cornelis Johannes Kieviet 1858-1931 COL 2e auteur VAL Vries, Daniël de Vries 1895-1959 COL editie VAL Zesde druk	1
COL titel VAL De @speelman op den Wildenborch COL ondertitel VAL een verhaal uit het jaar 1530 COL hoofdauteur VAL Gerdes, Eduard Gerdes 1821-1898 COL 2e auteur VAL Geerling, Otto Geerling 1850-1930 COL editie VAL 4e dr	COL titel VAL @Mijn eerste bijbel COL ondertitel VAL het Nieuwe Testament voor kinderen verteld	1
COL titel VAL @Moeder de Gans COL ondertitel VAL vertellingen uit de Oude Toover-Wereld COL 2e auteur VAL Perrault, Charles Perrault 1628-1703 COL 2e auteur VAL Coldewijn, Jacob Coldewijn 1796-1855 COL vertaling van VAL Charles Perrault: Contes de ma mère l'Oye. - 1697	COL titel VAL @Schepen COL ondertitel VAL pop-up COL 2e auteur VAL Žilák, Pavel Žilák	1
COL titel VAL @Vermoorde schuld COL hoofdauteur VAL Rendell, Ruth Rendell 1930-2015 COL 2e auteur VAL Kuipers, Hugo Kuipers 1954-2013 COL editie VAL 1e dr COL vertaling van VAL Harm done. - London : Hutchinson, cop. 1999	COL titel VAL @Was mit dem Fuchs geschah COL ondertitel VAL Märchen COL 2e auteur VAL Wasnezow, Jurij Alekseevič Vasnecov 1900-1973 COL 2e auteur VAL Angarowa, Hilde Angarowa COL vertaling van VAL →Skazki pro licu⇋	1
COL titel VAL Het @aapje COL ondertitel VAL horrorverhalen COL 2e auteur VAL Doyle, Arthur Conan Doyle 1859-1930	COL titel VAL @Speel piano met Dikkie Dik COL hoofdauteur VAL Boeke, Henriëtte Boeke 1948-	1
COL titel VAL De @val van een koningshuis, of Het eerste tijdperk van de Fransche Revolutie COL hoofdauteur VAL Andriessen, Pieter Jacob Andriessen 1815-1877 COL 2e auteur VAL Bos, Gerardus Johannes Bos 1825-1898 COL 2e auteur VAL Trap, Pieter Willem Marinus Trap 1821-1905 COL editie VAL 2e dr	COL titel VAL @Twintigduizend mijlen onder zee COL hoofdauteur VAL Verne, Jules Gabriel Verne 1828-1905 COL 2e auteur VAL Delden, Heinrich Herman van Delden 1936- COL 2e auteur VAL Stimson, Red B. Stimson COL vertaling van VAL Vingt mille lieues sous les mers	1
COL titel VAL De @kamer van de tsaar COL hoofdauteur VAL Konsalik, Heinz G. Konsalik COL 2e auteur VAL Amerongen, Jan van Amerongen 1939-1998 COL vertaling van VAL Das Bernsteinzimmer. - Bayreuth : Hestia, 1988	COL titel VAL @Strikt persoonlijk COL ondertitel VAL dagboek voor jongeren COL 2e auteur VAL Mauritz, Jan Hendrik Mauritz​ 1947-2023	1
COL titel VAL @Verloren in de Taïga COL hoofdauteur VAL Konsalik, Heinz G. Konsalik COL 2e auteur VAL Grashoff, Pieter Grashoff 1927-2010 COL vertaling van VAL Die Verdammten der Taïga. - Bayreuth : Hestia, 1975	COL titel VAL @Dikkie Dik COL ondertitel VAL voorleesboek COL hoofdauteur VAL Boeke, Henriëtte Boeke 1948- COL 2e auteur VAL Norden, Arthur van Norden 1947- COL editie VAL 1e dr COL auteur/primair VAL Boeke	1
COL titel VAL @Doornroosje COL 2e auteur VAL Kubas̆ta, Vojtĕch Kubas̆ta 1914-1992 COL 2e auteur VAL Perrault, Charles Perrault 1628-1703	COL titel VAL @Fairy tales from Africa COL 2e auteur VAL Adams, Marion Adams COL 2e auteur VAL Le Fanu, Brinsley Le Fanu 1854-1929	1
COL titel VAL @Eten COL ondertitel VAL een zig-zag-boek COL hoofdauteur VAL Bruna, Hendrik Magdalenus Bruna 1927-2017 COL 2e auteur VAL Groenendaal, Paul Groenendaal 1938- COL editie VAL [Herdr.]	COL titel VAL @Tijl Uilenspiegel COL ondertitel VAL van Uilenspiegels leven en daden en de wonderlijke avonturen die hij meemaakte COL 2e auteur VAL Noordzij, Marie-Cécile Noordzij-Pulles	1
COL titel VAL @Storm over Land's End COL hoofdauteur VAL Saris, Helena Barbara Wilhelmina Saris 1915-1999	COL titel VAL @Klein, groter, grootst COL hoofdauteur VAL Bruna, Hendrik Magdalenus Bruna 1927-2017 COL editie VAL 1st ed	1
COL titel VAL @Assepoester COL ondertitel VAL versjes van [J.P.J.H.] Clinge Doorenbos COL 2e auteur VAL Clinge Doorenbos, Johannes Pieter Jacobus Helmich Clinge Doorenbos 1884-1978	COL titel VAL @Sprookjens en verhalen van H.C. Andersen COL hoofdauteur VAL Andersen, Hans Christian Andersen 1805-1875 COL 2e auteur VAL Kate, Jan Jacob Lodewijk ten Kate 1819-1889	1
COL titel VAL Een @stoffelijk bewijs COL hoofdauteur VAL Thijssing-Boer, Henny Thijssing-Boer 1933-2011 COL auteur/primair VAL Thijssing-Boer	COL titel VAL @Tintin et le lac aux requins COL 2e auteur VAL Hergé, Hergé COL 2e auteur VAL Leblanc, Raymond Leblanc 1915-2008 COL 2e auteur VAL Greg, Greg 1931-1999	1
COL titel VAL @Dit voetje, dat voetje COL ondertitel VAL slaapliedjes en andere versjes van vroeger COL 2e auteur VAL Kuiper, Janna Gesiena Kuiper 1939- COL 2e auteur VAL Pfister, Marcus Pfister 1960- COL vertaling van VAL Weisst du wieviel Sternlein stehen. - Gossau [etc.] : Nord-Süd Verlag, cop. 1991	COL titel VAL The @English Van Alphen COL ondertitel VAL a collection of English poems for infant minds	1
COL titel VAL @Klein-Mannetje helpt een vriend COL hoofdauteur VAL Velthuijs, Max Velthuijs 1923-2005 COL editie VAL 4e dr COL vertaling van VAL Klein-Mannchen hilft einem Freund. - Mönchaltorf : Nord-Süd Verlag, 1986	COL titel VAL @Leren bidden	1
COL titel VAL @Klein-Mannetje heeft geen huis COL hoofdauteur VAL Velthuijs, Max Velthuijs 1923-2005 COL editie VAL 4e dr COL vertaling van VAL Klein Mannchen hat kein Haus. - Gossau Zürich : Nord-Süd Verlag, cop. 1983	COL titel VAL @Lies wie Nientje fliegt COL hoofdauteur VAL Bruna, Hendrik Magdalenus Bruna 1927-2017 COL 2e auteur VAL Harries, Edith Harries COL vertaling van VAL Nijntje vliegt. - Utrecht : Bruna, 1970	1
COL titel VAL De @schoorsteenveger COL hoofdauteur VAL Hermans, Willem Frederik Hermans 1921-1995	COL titel VAL @Stier COL ondertitel VAL 21 april-21 mei COL hoofdauteur VAL Busser, Marianne Busser 1958-2025 COL 2e auteur VAL Duffhaus, Marijke Duffhauss 1944-	1
COL titel VAL De @gemzenjager van Pra-del-Torno COL ondertitel VAL een verhaal uit de Waldenzenoorlog van 1561 COL hoofdauteur VAL Zeeuw, Pieter de Zeeuw J.Gzn. 1890-1968 COL 2e auteur VAL Isings, Johan Herman Isings Jr. 1884-1977	COL titel VAL @Nuttige en leerzame uitspannings uren van Willem en Emilia	1
COL titel VAL @Michael Strogoff COL ondertitel VAL de koerier van den czaar COL hoofdauteur VAL Verne, Jules Gabriel Verne 1828-1905 COL 2e auteur VAL Férat, Jules Férat 1829-1906 COL 2e auteur VAL Barbant, Ch. Barbant COL vertaling van VAL Michel Strogoff, le courier de tsar. - 1876	COL titel VAL @Leonard Roggeveen omnibus COL hoofdauteur VAL Roggeveen, Leonard Roggeveen 1898-1959 COL 2e auteur VAL Dicke, Otto Dingeman Dicke 1918-1984	1
COL titel VAL @Boerderijdieren	COL titel VAL @Dagen van liefde COL hoofdauteur VAL Cookson, Catherine Anne Cookson 1906-1998 COL 2e auteur VAL Vastbinder, Mieke Vastbinder COL vertaling van VAL The bondage of love. - London [etc.] : Bantam Press, 1997	1
COL titel VAL @Dieren	COL titel VAL Het @volle hart COL ondertitel VAL schrijven over emoties COL 2e auteur VAL De Bel, Marc De Bel 1954- COL 2e auteur VAL Verbanck, Jan Verbanck 1958-	1
COL titel VAL Het @kleine reuzeboekje COL ondertitel VAL moppen	COL titel VAL @Van alles wat COL ondertitel VAL kleine bijdragen in poëzy en proza COL 2e auteur VAL Bouwmeester, Johannes Wilhelmus Bouwmeester 1804-1892 COL 2e auteur VAL Last, Carel Christiaan Antony Last 1808-1876 COL Eerder verschenen o.d.t. VAL Moeders schoot. Nieuwe Serie ; 8	1
COL titel VAL @In de verte wordt het licht COL hoofdauteur VAL Peters, Karin Peters COL auteur/primair VAL Peters	COL titel VAL @Niet storen! COL hoofdauteur VAL Mansell, Jill Mansell 1957- COL 2e auteur VAL Oltheten, Annemieke Oltheten COL vertaling van VAL Staying at Daisy's. - London : Headline, 2002	1
COL titel VAL @Nader tot U COL hoofdauteur VAL Reve, Gerard Kornelis van het Reve 1923-2006 COL editie VAL 22e dr	COL titel VAL De @reis naar de maan in 28 dagen en 12 uren COL hoofdauteur VAL Verne, Jules Gabriel Verne 1828-1905 COL editie VAL 27e dr COL vertaling van VAL De la terre à la lune	1
COL titel VAL De @geest COL hoofdauteur VAL Steel, Danielle Fernande Steel 1947- COL 2e auteur VAL Duzee, Lucien Antoine Duzee 1943-2016 COL editie VAL 2e dr COL vertaling van VAL The ghost. - New York : Delacorte Press, 1997	COL titel VAL Het @boek van Kees COL hoofdauteur VAL Vries, Anne de Vries 1904-1964 COL 2e auteur VAL Bottema, Tjeerd Bottema 1884-1978 COL 2e auteur VAL Crans COL editie VAL 8e dr	1
COL titel VAL De @volmaakte vreemdeling COL hoofdauteur VAL Steel, Danielle Fernande Steel 1947- COL 2e auteur VAL Versluys, M.V. Versluys 1941- COL editie VAL 2e dr COL vertaling van VAL A perfect stranger. - 1981	COL titel VAL @Nijntje op reis COL 2e auteur VAL Deitch, Gene Deitch COL 2e auteur VAL Bruna, Hendrik Magdalenus Bruna 1927-2017 COL 2e auteur VAL Celba, Jaroslav Celba	1
COL titel VAL @Kapers op de kust COL hoofdauteur VAL Mansell, Jill Mansell 1957- COL 2e auteur VAL Benink, Carla Benink COL editie VAL 2e dr COL vertaling van VAL Sheer mischief. - Toronto [etc.] : Bantam Books, 1994	COL titel VAL @Van alles wat COL 2e auteur VAL Bloemink-Rehwinkel, L.G.J. Bloemink-Rehwinkel COL 2e auteur VAL Koopmans, Loek Koopmans 1943-	1
COL titel VAL @Kinderzegen COL hoofdauteur VAL Steel, Danielle Fernande Steel 1947- COL 2e auteur VAL Wieberdink, Ineke Wieberdink-Westerweel COL editie VAL 2e dr COL vertaling van VAL Mixed blessings. - New York : Delacorte Press, 1992	COL titel VAL De @Kingfordschool COL hoofdauteur VAL Marxveldt, Cissy van Marxveldt 1889-1948 COL 2e auteur VAL Mens, Isidorus Maria Cornelis van Mens 1890-1985	1
COL titel VAL @Verslag uit Vietnam COL hoofdauteur VAL Steel, Danielle Fernande Steel 1947- COL 2e auteur VAL Lakens Douwes, Marianne Lakens Douwes COL editie VAL 2e dr COL vertaling van VAL Message from Nam. - London [etc.] : Bantam Press, 1990	COL titel VAL @Dierensprookjes van Andersen COL hoofdauteur VAL Andersen, Hans Christian Andersen 1805-1875 COL 2e auteur VAL Mechelen, Cato Van Mechelen	1
COL titel VAL @Razernij COL hoofdauteur VAL King, Stephen Edwin King 1947- COL 2e auteur VAL Bakker, Margot Bakker COL 2e auteur VAL Nijhuis, Marian Nijhuis COL vertaling van VAL Rage / Richard Bachman. - New York : New American Library, 1977 COL Eerder verschenen in VAL 4× Stephen King (Richard Bachman). - Utrecht : Luitingh, 1986	COL titel VAL @Reis naar Rio COL hoofdauteur VAL Saris, Helena Barbara Wilhelmina Saris 1915-1999	1
COL titel VAL @Sneeuwwitje COL 2e auteur VAL Kubas̆ta, Vojtĕch Kubas̆ta 1914-1992	COL titel VAL @Onderwijs in Nieuw Guinea COL 2e auteur VAL Matti, Anna Maria Gabrielle Matti 1929-1995 COL 2e auteur VAL Spekking, Wilhelmus Bernardus Maria Spekking 1924-1996	1
COL titel VAL @Mijn auto COL 2e auteur VAL Constant, Anne-Marie Constant COL 2e auteur VAL Hemmerlin, M.A. Hemmerlin	COL titel VAL @5 dagen in Parijs COL hoofdauteur VAL Steel, Danielle Fernande Steel 1947- COL 2e auteur VAL Lakens Douwes, Marianne Lakens Douwes COL vertaling van VAL Five days in Paris. - Cop. 1995	1
COL titel VAL @Werk in uitvoering COL hoofdauteur VAL King, Stephen Edwin King 1947- COL 2e auteur VAL Kuipers, Hugo Kuipers 1954-2013 COL vertaling van VAL Roadwork / Richard Bachman. - New York : New American Library, 1981 COL Eerder verschenen in VAL 4× Stephen King (Richard Bachman). - Utrecht : Luitingh, 1986	COL titel VAL De @mooiste sportverhalen COL 2e auteur VAL Beurskens, Hubertus Peter Willem Beurskens 1950- COL Oorspr. titel VAL Hup! : sportieve verhalen uit de wereldliteratuur. - Amsterdam : Meulenhoff, 1990	1
COL titel VAL @Vlucht naar de top COL hoofdauteur VAL King, Stephen Edwin King 1947- COL 2e auteur VAL Groot, Frank de Groot COL vertaling van VAL The running man / Richard Bachman. - New York : New American Library, 1982 COL Eerder verschenen in VAL 4× Stephen King (Richard Bachman). - Utrecht : Luitingh, 1986	COL titel VAL @Rikki en zijn vriendjes COL hoofdauteur VAL Van Genechten, Guido Van Genechten 1957- COL editie VAL 4e dr	1
COL titel VAL De @Matarese finale COL hoofdauteur VAL Ludlum, Robert Ludlum 1927-2001 COL 2e auteur VAL Jansen in de Wal, Martin Jansen in de Wal COL editie VAL 5e dr COL vertaling van VAL The Matarese countdown. - New York : Baror International, cop. 1997	COL titel VAL @Moeder: een engel zonder vleugels COL ondertitel VAL een boek voor alle moeders geschreven door kinderen COL 2e auteur VAL Exley, Richard Exley COL 2e auteur VAL Exley, Helen Exley COL 2e auteur VAL Sijmons, Ingrid Sijmons 1943-1998 COL vertaling van VAL To mum	1
COL titel VAL @Onder onsjes COL ondertitel VAL een verzameling verhalen, versjes, spelletjes, raadsels, knutselwerkjes, enz. enz. COL 2e auteur VAL Blaauw, Henriëtte Blaauw 1875-1949 COL 2e auteur VAL Geerling, Otto Geerling 1850-1930 COL editie VAL 3e dr	COL titel VAL Het @verhaal van Aladdin en de wonderlamp COL 2e auteur VAL Leeuwen, Richard Louis Anton van Leeuwen 1955- COL vertaling van VAL Histoire d'ʿAlā al-Dīn, ou La lampe merveilleuse. - Paris : Imprimerie Nationale, 1888	1
COL titel VAL @Voor zomer en winter COL ondertitel VAL een verzameling verhalen, sprookjes, versjes, rijmpjes, kunstjes, knutselwerkjes, raadsels, handwerkjes, schaduwbeelden, spelletjes, enz., enz. COL 2e auteur VAL Blaauw, Henriëtte Blaauw 1875-1949 COL 2e auteur VAL Morris, M. Morris	COL titel VAL @Annelies COL hoofdauteur VAL Hulst, Willem Gerrit van de Hulst 1879-1963 COL 2e auteur VAL Hulst, Willem Gerrit van de Hulst 1917-2006 COL editie VAL 6e dr., 81e-92e duiz	1
COL titel VAL De @bijbelsche geschiedenis aan kinderen verteld COL 2e auteur VAL Donner, Johannes Hendrikus Donner 1824-1903 COL editie VAL 10e dr	COL titel VAL De @leukste verhalen van Sinterklaas	1
COL titel VAL @Oorlog en vrede COL ondertitel VAL historische roman van Leo graaf Tolstoï COL hoofdauteur VAL Tolstoï, L.N. Tolstoj 1828-1910 COL 2e auteur VAL Tuuk, Titia Klasina Elisabeth van der Tuuk 1854-1939 COL 2e auteur VAL Keller, Gerard Keller 1829-1899	COL titel VAL @Michael Strogoff COL ondertitel VAL de koerier van de tsaar COL hoofdauteur VAL Verne, Jules Gabriel Verne 1828-1905 COL 2e auteur VAL Aardweg, Hans Petrus van den Aardweg 1899-1971 COL vertaling van VAL Michael Strogoff, le courier du tsar. - 1876	1
COL titel VAL @Oorlog en vrede COL ondertitel VAL historische roman van Leo graaf Tolstoï COL hoofdauteur VAL Tolstoï, L.N. Tolstoj 1828-1910 COL 2e auteur VAL Tuuk, Titia Klasina Elisabeth van der Tuuk 1854-1939 COL 2e auteur VAL Keller, Gerard Keller 1829-1899	COL titel VAL De @vervoermiddelen	1
COL titel VAL @Oorlog en vrede COL ondertitel VAL historische roman van Leo graaf Tolstoï COL hoofdauteur VAL Tolstoï, L.N. Tolstoj 1828-1910 COL 2e auteur VAL Tuuk, Titia Klasina Elisabeth van der Tuuk 1854-1939 COL 2e auteur VAL Keller, Gerard Keller 1829-1899	COL titel VAL Het @kanarievogeltje en de gouden eitjes	1
COL titel VAL @Miffy's birthday COL hoofdauteur VAL Bruna, Hendrik Magdalenus Bruna 1927-2017 COL vertaling van VAL Het feest van Nijntje. - Utrecht : Bruna & Zoon, [1970]	COL titel VAL @Hun tweede keus COL hoofdauteur VAL Peters, Karin Peters	1
COL titel VAL De @bijbelsche geschiedenissen COL hoofdauteur VAL Hulst, Willem Gerrit van de Hulst 1879-1963 COL 2e auteur VAL Isings, Johan Herman Isings Jr. 1884-1977 COL editie VAL 6e dr	COL titel VAL @Jaap Holm en z'n vrinden COL hoofdauteur VAL Hulst, Willem Gerrit van de Hulst 1879-1963 COL 2e auteur VAL Schröder, Sierk Carl Schröder 1903-2002 COL editie VAL 15e dr	1
COL titel VAL De @stroper COL hoofdauteur VAL Vries, Anne de Vries 1904-1964 COL 2e auteur VAL Lutz, Johannes Hermanus Lutz 1888-1957 COL editie VAL [1e dr.]	COL titel VAL @Verkorte geschiedenis van Robinson Crusoë COL 2e auteur VAL Defoe, Daniel Defoe 1661-1731 COL 2e auteur VAL Oort, Matthieu van Oort COL editie VAL Nieuwe verb. dr	1
COL titel VAL The @green mile COL ondertitel VAL een verhaal in zes delen COL hoofdauteur VAL King, Stephen Edwin King 1947- COL 2e auteur VAL Kuipers, Hugo Kuipers 1954-2013 COL editie VAL 4e dr COL vertaling van VAL The green mile. - London [etc.] : Penguin Books, cop. 1996 COL Oorspr. titel VAL De groene mijl. - Amsterdam : Luitingh-Sijthoff, 1998. - Oorspr. Nederlandse uitg. in 6 dl.: Amsterdam : Poema Pocket, 1996	COL titel VAL @Sevginin gücü COL 2e auteur VAL Disney, Walter Elias Disney 1901-1966 COL 2e auteur VAL Sakacı, Sibel Sakacı COL vertaling van VAL Getting to know you. - New York : Disney, 2003	1
COL titel VAL De @laatste roker COL ondertitel VAL verhalen COL hoofdauteur VAL Hermans, Willem Frederik Hermans 1921-1995 COL editie VAL 8e dr	COL titel VAL @Geluk gloort aan de horizon COL hoofdauteur VAL Cookson, Catherine Anne Cookson 1906-1998 COL 2e auteur VAL Berghand, Arjen Berghand COL editie VAL 3e dr COL vertaling van VAL Hannah Massey. - London : MacDonald, 1964 COL Oorspr. Nederlandse titel VAL De slang en Eva. - Utrecht : De Lanteern, 1966	1
COL titel VAL @Vijf weken in een luchtballon COL ondertitel VAL ontdekkingsreis in de binnenlanden van Afrika COL hoofdauteur VAL Verne, Jules Gabriel Verne 1828-1905 COL vertaling van VAL Cinq semaines en ballon. - 1863 COL Oorspr. titel VAL Vijf weken in een luchtbal : merkwaardige luchtreis van drie Engelschen door Afrika. - Amsterdam [etc.] : Binger [etc.], 1864	COL titel VAL De @luchthartige mandarijn COL ondertitel VAL liefdesavonturen van Hsi Men en zijn zes vrouwen COL ondertitel VAL naar een Chineesche familiekroniek uit de 12e eeuw COL 2e auteur VAL Kelk, Cornelis Jan Kelk 1901-1981 COL 2e auteur VAL Holman, Léon Holman	1
